Rk,Player,Nation,Pos,Squad,Comp,Age,Born,90s,Tkl,TklW,Def 3rd,Mid 3rd,Att 3rd,Challenges Tkl,Att,Tkl%,Lost,Blocks,Sh,Pass,Int,Tkl+Int,Clr,Err,Matches
1,Brenden Aaronson,USA,"MF,FW",Leeds United,Premier League,21,2000,26.4,45,18,16,22,7,15,46,32.6,31,43,3,40,5,50,6,1,Matches
2,Paxten Aaronson,USA,"MF,DF",Eint Frankfurt,Bundesliga,18,2003,1.9,6,5,2,2,2,2,3,66.7,1,2,1,1,0,6,2,0,Matches
3,James Abankwah,IRL,DF,Udinese,Serie A,18,2004,0.7,1,1,0,1,0,0,0,0.0,0,4,2,2,0,1,5,0,Matches
4,George Abbott,ENG,MF,Tottenham,Premier League,16,2005,0.0,0,0,0,0,0,0,0,0.0,0,0,0,0,1,1,0,0,Matches
5,Yunis Abdelhamid,MAR,DF,Reims,Ligue 1,34,1987,37.0,82,50,47,33,2,39,52,75.0,13,65,27,38,64,146,116,1,Matches
6,Himad Abdelli,ALG,"MF,FW",Angers,Ligue 1,22,1999,23.7,64,38,22,32,10,31,67,46.3,36,30,1,29,28,92,15,0,Matches
7,Salis Abdul Samed,GHA,MF,Lens,Ligue 1,22,2000,32.2,46,26,18,23,5,29,52,55.8,23,38,9,29,36,82,26,0,Matches
8,Laurent Abergel,FRA,MF,Lorient,Ligue 1,29,1993,26.0,92,52,59,30,3,39,92,42.4,53,47,8,39,34,126,39,0,Matches
9,Oliver Abildgaard,DEN,MF,Hellas Verona,Serie A,26,1996,6.6,10,6,6,3,1,7,16,43.8,9,7,1,6,5,15,17,0,Matches
10,Matthis Abline,FRA,"FW,MF",Auxerre,Ligue 1,19,2003,9.0,4,2,0,3,1,0,5,0.0,5,6,1,5,1,5,1,0,Matches
11,Matthis Abline,FRA,"FW,MF",Rennes,Ligue 1,19,2003,1.2,1,1,0,0,1,1,1,100.0,0,1,0,1,2,3,1,0,Matches
12,Abner,BRA,DF,Betis,La Liga,22,2000,6.7,12,9,9,2,1,7,16,43.8,9,8,2,6,8,20,24,0,Matches
13,Zakaria Aboukhlal,MAR,"FW,MF",Toulouse,Ligue 1,22,2000,27.5,33,23,13,9,11,14,45,31.1,31,18,1,17,22,55,23,0,Matches
14,Tammy Abraham,ENG,FW,Roma,Serie A,24,1997,24.3,17,10,4,8,5,3,16,18.8,13,10,4,6,3,20,14,0,Matches
15,Christian Acella,ITA,MF,Cremonese,Serie A,20,2002,0.2,1,0,1,0,0,0,2,0.0,2,0,0,0,0,1,0,0,Matches
16,Francesco Acerbi,ITA,DF,Inter,Serie A,34,1988,26.9,33,19,22,7,4,20,27,74.1,7,25,18,7,41,74,85,2,Matches
17,Álvaro Aceves,ESP,GK,Valladolid,La Liga,19,2003,0.1,0,0,0,0,0,0,0,0.0,0,0,0,0,0,0,0,0,Matches
18,Mohamed Achi,FRA,FW,Nantes,Ligue 1,20,2002,0.4,1,1,1,0,0,1,1,100.0,0,0,0,0,0,1,0,0,Matches
19,Marcos Acuña,ARG,DF,Sevilla,La Liga,30,1991,21.2,57,36,34,17,6,30,42,71.4,12,16,5,11,23,80,36,0,Matches
20,Che Adams,SCO,FW,Southampton,Premier League,26,1996,22.1,17,13,7,8,2,7,12,58.3,5,13,4,9,4,21,22,0,Matches
21,Tyler Adams,USA,MF,Leeds United,Premier League,23,1999,24.0,89,46,44,35,10,50,77,64.9,27,48,8,40,35,124,29,0,Matches
22,Sargis Adamyan,ARM,"FW,MF",Köln,Bundesliga,29,1993,7.2,14,7,5,3,6,7,17,41.2,10,12,0,12,4,18,5,0,Matches
23,Tosin Adarabioyo,ENG,DF,Fulham,Premier League,24,1997,23.2,30,13,22,6,2,16,23,69.6,7,20,15,5,26,56,140,1,Matches
24,Martin Adeline,FRA,"MF,FW",Reims,Ligue 1,18,2003,1.2,3,3,2,1,0,3,4,75.0,1,3,1,2,3,6,3,0,Matches
25,Karim Adeyemi,GER,"FW,MF",Dortmund,Bundesliga,20,2002,15.4,16,11,6,6,4,8,30,26.7,22,18,1,17,7,23,3,0,Matches
26,Amine Adli,MAR,"FW,MF",Leverkusen,Bundesliga,22,2000,15.9,18,10,4,6,8,5,17,29.4,12,28,2,26,6,24,7,0,Matches
27,Yacine Adli,FRA,"MF,FW",Milan,Serie A,22,2000,1.6,6,3,2,4,0,2,2,100.0,0,2,0,2,1,7,1,0,Matches
28,Michel Aebischer,SUI,"FW,MF",Bologna,Serie A,25,1997,17.1,12,6,3,6,3,2,18,11.1,16,14,2,12,7,19,9,0,Matches
29,Felix Afena-Gyan,GHA,"FW,MF",Cremonese,Serie A,19,2003,9.1,7,3,4,1,2,2,10,20.0,8,5,1,4,1,8,6,0,Matches
30,Emmanuel Agbadou,CIV,DF,Reims,Ligue 1,25,1997,26.5,71,49,53,16,2,42,65,64.6,23,30,14,16,32,103,107,3,Matches
31,Julen Agirrezabala,ESP,GK,Athletic Club,La Liga,21,2000,7.5,0,0,0,0,0,0,0,0.0,0,0,0,0,0,0,2,0,Matches
32,Lucien Agoume,FRA,MF,Troyes,Ligue 1,20,2002,12.2,42,25,18,15,9,17,33,51.5,16,14,5,9,27,69,24,0,Matches
33,Felix Agu,GER,"DF,FW",Werder Bremen,Bundesliga,22,1999,0.5,1,0,0,1,0,0,0,0.0,0,1,1,0,0,1,0,0,Matches
34,Álvaro Aguado,ESP,MF,Valladolid,La Liga,26,1996,21.0,27,15,13,11,3,15,25,60.0,10,16,4,12,13,40,15,0,Matches
35,Kevin Agudelo,COL,"MF,FW",Spezia,Serie A,23,1998,23.7,71,38,22,30,19,25,59,42.4,34,39,5,34,10,81,6,0,Matches
36,Nayef Aguerd,MAR,DF,West Ham,Premier League,26,1996,17.7,27,18,18,8,1,13,20,65.0,7,26,24,2,18,45,79,2,Matches
37,Ruben Aguilar,FRA,DF,Monaco,Ligue 1,29,1993,13.0,19,9,7,7,5,8,22,36.4,14,13,1,12,18,37,28,1,Matches
38,Naouirou Ahamada,FRA,"MF,FW",Crystal Palace,Premier League,20,2002,1.0,3,2,3,0,0,1,3,33.3,2,2,0,2,0,3,0,0,Matches
39,Naouirou Ahamada,FRA,MF,Stuttgart,Bundesliga,20,2002,15.5,17,11,7,7,3,8,20,40.0,12,16,5,11,8,25,7,0,Matches
40,Amar Ahmed,SWE,FW,Troyes,Ligue 1,18,2004,0.2,1,1,0,1,0,0,1,0.0,1,0,0,0,1,2,0,0,Matches
41,Jean-Eudes Aholou,CIV,MF,Strasbourg,Ligue 1,28,1994,14.4,34,20,10,20,4,12,31,38.7,19,25,0,25,24,58,15,0,Matches
42,Joseph Aidoo,GHA,DF,Celta Vigo,La Liga,26,1995,34.7,51,36,33,17,1,16,28,57.1,12,26,14,12,31,82,150,0,Matches
43,Ola Aina,NGA,DF,Torino,Serie A,25,1996,9.7,17,13,5,8,4,9,15,60.0,6,12,2,10,11,28,26,0,Matches
44,Rayan Aït Nouri,ALG,DF,Wolves,Premier League,21,2001,12.0,33,20,25,7,1,9,15,60.0,6,3,0,3,9,42,28,0,Matches
45,Emanuel Aiwum,AUT,DF,Cremonese,Serie A,21,2000,18.4,55,34,36,17,2,33,47,70.2,14,28,16,12,25,80,52,3,Matches
46,Kristoffer Ajer,NOR,DF,Brentford,Premier League,24,1998,8.5,11,8,5,4,2,9,16,56.3,7,6,5,1,7,18,22,0,Matches
47,Ludovic Ajorque,FRA,FW,Strasbourg,Ligue 1,28,1994,8.6,5,4,1,4,0,3,9,33.3,6,3,1,2,2,7,7,0,Matches
48,Ludovic Ajorque,FRA,"FW,MF",Mainz 05,Bundesliga,28,1994,13.5,6,5,1,4,1,1,9,11.1,8,8,2,6,1,7,8,0,Matches
49,Manuel Akanji,SUI,DF,Manchester City,Premier League,27,1995,25.4,36,25,15,18,3,23,36,63.9,13,27,9,18,16,52,33,0,Matches
50,Nathan Aké,NED,DF,Manchester City,Premier League,27,1995,20.8,26,12,15,9,2,11,15,73.3,4,20,10,10,20,46,48,0,Matches
51,Sergio Akieme,ESP,DF,Almería,La Liga,24,1997,25.5,27,16,19,6,2,12,22,54.5,10,22,6,16,14,41,41,0,Matches
52,Babatunde Akinsola,NGA,FW,Valladolid,La Liga,19,2003,0.1,1,1,0,0,1,0,0,0.0,0,0,0,0,0,1,0,0,Matches
53,Maghnes Akliouche,FRA,"MF,FW",Monaco,Ligue 1,20,2002,4.5,7,4,4,3,0,2,8,25.0,6,2,0,2,3,10,2,0,Matches
54,Paul Akouokou,CIV,"MF,DF",Betis,La Liga,24,1997,5.0,16,9,13,3,0,13,20,65.0,7,2,2,0,12,28,17,1,Matches
55,Jean-Daniel Akpa-Akpro,CIV,"MF,FW",Empoli,Serie A,29,1992,15.1,53,37,25,19,9,23,42,54.8,19,35,4,31,13,66,27,0,Matches
56,Kevin Akpoguma,NGA,DF,Hoffenheim,Bundesliga,27,1995,21.7,75,44,45,27,3,32,45,71.1,13,45,16,29,24,99,70,1,Matches
57,David Alaba,AUT,DF,Real Madrid,La Liga,30,1992,20.4,15,11,8,4,3,9,15,60.0,6,18,9,9,14,29,37,1,Matches
58,Ángel Alarcón,ESP,FW,Barcelona,La Liga,18,2004,0.3,0,0,0,0,0,0,0,0.0,0,0,0,0,0,0,0,0,Matches
59,Tomás Alarcón,CHI,MF,Cádiz,La Liga,23,1999,2.5,3,2,0,2,1,1,2,50.0,1,1,0,1,2,5,2,0,Matches
60,Lucas Alario,ARG,"FW,MF",Eint Frankfurt,Bundesliga,29,1992,3.7,3,2,1,0,2,0,1,0.0,1,0,0,0,2,5,13,0,Matches
61,Jordi Alba,ESP,DF,Barcelona,La Liga,33,1989,15.8,25,18,13,11,1,12,28,42.9,16,12,5,7,11,36,23,0,Matches
62,Luis Alberto,ESP,MF,Lazio,Serie A,29,1992,27.1,49,29,18,20,11,23,72,31.9,49,35,6,29,9,58,4,0,Matches
63,Raúl Albiol,ESP,DF,Villarreal,La Liga,36,1985,23.5,25,17,17,6,2,14,18,77.8,4,17,13,4,14,39,111,0,Matches
64,Marc Albrighton,ENG,"FW,MF",Leicester City,Premier League,32,1989,2.6,4,1,0,2,2,1,8,12.5,7,6,2,4,1,5,5,0,Matches
65,Thiago Alcántara,ESP,MF,Liverpool,Premier League,31,1991,13.9,43,24,20,21,2,14,23,60.9,9,15,3,12,21,64,13,2,Matches
66,Carlos Alcaraz,ARG,"MF,FW",Southampton,Premier League,19,2002,11.4,10,5,2,7,1,6,22,27.3,16,14,5,9,1,11,11,0,Matches
67,Rubén Alcaraz,ESP,MF,Cádiz,La Liga,31,1991,22.7,43,31,24,18,1,19,54,35.2,35,23,8,15,19,62,37,0,Matches
68,Omar Alderete,PAR,DF,Getafe,La Liga,25,1996,22.7,35,20,21,14,0,28,40,70.0,12,23,16,7,26,61,85,0,Matches
69,Iván Alejo,ESP,"MF,FW",Cádiz,La Liga,27,1995,14.6,32,21,19,9,4,17,37,45.9,20,18,3,15,5,37,12,1,Matches
70,Doğan Alemdar,TUR,GK,Rennes,Ligue 1,19,2002,4.5,0,0,0,0,0,0,0,0.0,0,0,0,0,0,0,1,1,Matches
71,Carles Aleñá,ESP,"MF,FW",Getafe,La Liga,24,1998,23.5,18,10,7,5,6,5,34,14.7,29,19,1,18,4,22,18,0,Matches
72,Trent Alexander-Arnold,ENG,DF,Liverpool,Premier League,23,1998,32.5,57,40,32,16,9,42,79,53.2,37,25,7,18,43,100,41,2,Matches
73,Alejandro Alfaro,ESP,MF,Elche,La Liga,20,2002,0.2,0,0,0,0,0,0,0,0.0,0,0,0,0,0,0,0,0,Matches
74,Ángel Algobia,ESP,MF,Getafe,La Liga,23,1999,12.6,27,13,14,13,0,22,48,45.8,26,15,5,10,3,30,11,0,Matches
75,Mohamed Ali Cho,FRA,"FW,MF",Real Sociedad,La Liga,18,2004,6.5,13,10,6,5,2,4,10,40.0,6,9,0,9,2,15,2,0,Matches
76,Faride Alidou,GER,"DF,MF",Eint Frankfurt,Bundesliga,21,2001,2.0,8,5,3,4,1,3,9,33.3,6,3,0,3,1,9,3,0,Matches
77,Alisson,BRA,GK,Liverpool,Premier League,29,1992,37.0,0,0,0,0,0,0,3,0.0,3,3,0,3,0,0,20,0,Matches
78,Jim Allevinah,GAB,"DF,FW",Clermont Foot,Ligue 1,27,1995,24.9,39,24,24,11,4,19,62,30.6,43,24,2,22,24,63,26,1,Matches
79,Dele Alli,ENG,MF,Everton,Premier League,26,1996,0.4,0,0,0,0,0,0,0,0.0,0,0,0,0,0,0,0,0,Matches
80,Domingos André Ribeiro Almeida,POR,MF,Valencia,La Liga,22,2000,28.2,66,42,23,32,11,26,57,45.6,31,26,0,26,20,86,16,1,Matches
81,Miguel Almirón,PAR,FW,Newcastle Utd,Premier League,28,1994,27.7,46,30,16,19,11,18,42,42.9,24,25,2,23,10,56,17,0,Matches
82,Marcos Alonso,ESP,DF,Barcelona,La Liga,31,1990,13.0,15,10,10,5,0,9,12,75.0,3,14,10,4,11,26,32,0,Matches
83,Mickaël Alphonse,GLP,DF,Ajaccio,Ligue 1,33,1989,15.1,35,23,20,11,4,20,33,60.6,13,17,5,12,35,70,44,1,Matches
84,Éder Álvarez Balanta,COL,"MF,FW",Schalke 04,Bundesliga,29,1993,2.6,5,4,2,3,0,2,6,33.3,4,0,0,0,3,8,4,0,Matches
85,Carlos Álvarez,ESP,MF,Sevilla,La Liga,18,2003,0.1,1,1,0,1,0,0,0,0.0,0,0,0,0,0,1,0,0,Matches
86,Gastón Álvarez,URU,DF,Getafe,La Liga,22,2000,16.7,38,30,24,9,5,23,42,54.8,19,15,5,10,15,53,35,0,Matches
87,Julián Álvarez,ARG,"FW,MF",Manchester City,Premier League,22,2000,16.3,26,16,3,13,10,9,29,31.0,20,13,0,13,2,28,6,0,Matches
88,Agustín Álvarez Martínez,URU,"FW,MF",Sassuolo,Serie A,21,2001,4.1,6,3,0,5,1,1,4,25.0,3,5,1,4,3,9,3,0,Matches
89,Yeray Álvarez,ESP,DF,Athletic Club,La Liga,27,1995,25.9,34,23,26,7,1,24,31,77.4,7,23,13,10,48,82,101,0,Matches
90,Ibrahim Amadou,FRA,"DF,MF",Angers,Ligue 1,29,1993,4.7,10,7,6,3,1,7,11,63.6,4,7,3,4,10,20,20,0,Matches
91,Selim Amallah,MAR,"MF,FW",Valladolid,La Liga,25,1996,3.0,15,9,7,8,0,5,8,62.5,3,2,0,2,5,20,2,0,Matches
92,Daniel Amartey,GHA,DF,Leicester City,Premier League,27,1994,17.9,19,8,13,5,1,12,14,85.7,2,24,17,7,8,27,71,0,Matches
93,Amath,SEN,"MF,FW",Mallorca,La Liga,26,1996,13.6,29,19,14,8,7,14,22,63.6,8,13,1,12,5,34,5,0,Matches
94,Jordan Amavi,FRA,DF,Getafe,La Liga,28,1994,2.2,3,2,3,0,0,1,3,33.3,2,3,0,3,4,7,7,0,Matches
95,Lukáš Ambros,CZE,MF,Wolfsburg,Bundesliga,18,2004,0.2,1,0,1,0,0,1,4,25.0,3,1,0,1,0,1,2,1,Matches
96,Kelvin Amian,FRA,DF,Spezia,Serie A,24,1998,26.4,54,32,33,12,9,24,31,77.4,7,34,12,22,22,76,87,1,Matches
97,Bruno Amione,ARG,DF,Hellas Verona,Serie A,20,2002,0.6,1,1,1,0,0,1,2,50.0,1,1,0,1,0,1,4,0,Matches
98,Bruno Amione,ARG,DF,Sampdoria,Serie A,20,2002,23.2,50,33,36,14,0,19,43,44.2,24,26,11,15,25,75,62,1,Matches
99,Nadiem Amiri,GER,"MF,FW",Leverkusen,Bundesliga,25,1996,10.9,15,6,5,8,2,9,20,45.0,11,12,1,11,6,21,10,2,Matches
100,Samuel Amo-Ameyaw,ENG,MF,Southampton,Premier League,16,2006,0.0,0,0,0,0,0,0,1,0.0,1,0,0,0,0,0,0,0,Matches
101,Ethan Ampadu,WAL,"DF,MF",Spezia,Serie A,21,2000,29.3,66,37,33,28,5,17,41,41.5,24,48,23,25,36,102,98,0,Matches
102,Sofyan Amrabat,MAR,MF,Fiorentina,Serie A,25,1996,22.2,39,24,15,17,7,16,29,55.2,13,23,5,18,21,60,18,2,Matches
103,Ayoub Amraoui,MAR,"DF,FW",Nice,Ligue 1,18,2004,3.3,6,5,3,3,0,2,5,40.0,3,1,0,1,4,10,4,0,Matches
104,Joachim Andersen,DEN,DF,Crystal Palace,Premier League,26,1996,30.9,42,22,30,12,0,16,32,50.0,16,28,13,15,24,66,188,0,Matches
105,Elliot Anderson,SCO,"MF,FW",Newcastle Utd,Premier League,19,2002,4.6,11,5,5,3,3,6,12,50.0,6,11,2,9,6,17,2,0,Matches
106,Felipe Anderson,BRA,FW,Lazio,Serie A,29,1993,32.9,80,50,31,41,8,31,88,35.2,57,58,6,52,31,111,27,0,Matches
107,Benjamin André,FRA,MF,Lille,Ligue 1,31,1990,32.4,128,74,51,60,17,65,121,53.7,56,50,8,42,47,175,60,0,Matches
108,Marcos André,BRA,"FW,MF",Valencia,La Liga,25,1996,5.0,4,1,1,1,2,1,2,50.0,1,4,1,3,0,4,0,0,Matches
109,Komnen Andrić,SRB,FW,Clermont Foot,Ligue 1,27,1995,16.1,13,5,2,7,4,2,15,13.3,13,8,1,7,8,21,13,0,Matches
110,Robert Andrich,GER,MF,Leverkusen,Bundesliga,27,1994,26.7,61,38,30,27,4,26,45,57.8,19,27,9,18,42,103,55,2,Matches
111,Angeliño,ESP,DF,Hoffenheim,Bundesliga,25,1997,29.1,40,24,19,18,3,23,37,62.2,14,32,6,26,25,65,67,0,Matches
112,Fabrizio Angileri,ARG,DF,Getafe,La Liga,28,1994,6.5,12,9,8,3,1,10,17,58.8,7,8,3,5,7,19,10,0,Matches
113,Jaidon Anthony,ENG,"MF,FW",Bournemouth,Premier League,22,1999,14.0,30,17,15,9,6,8,24,33.3,16,30,3,27,10,40,19,0,Matches
114,Janis Antiste,FRA,FW,Sassuolo,Serie A,19,2002,0.6,1,0,1,0,0,1,1,100.0,0,0,0,0,0,1,0,0,Matches
115,Waldemar Anton,GER,DF,Stuttgart,Bundesliga,26,1996,32.6,49,27,27,19,3,27,51,52.9,24,44,16,28,38,87,123,2,Matches
116,Josep Antoni Gayá,ESP,"DF,MF",Mallorca,La Liga,22,2000,1.1,0,0,0,0,0,0,0,0.0,0,4,2,2,1,1,6,0,Matches
117,José Antonio,ESP,"MF,DF",Cádiz,La Liga,18,2004,0.5,2,1,0,0,2,0,0,0.0,0,0,0,0,0,2,0,0,Matches
118,Marcos Antônio,BRA,MF,Lazio,Serie A,22,2000,6.6,9,6,4,5,0,9,20,45.0,11,7,2,5,11,20,18,0,Matches
119,Michail Antonio,JAM,FW,West Ham,Premier League,32,1990,20.3,14,7,1,8,5,3,12,25.0,9,13,5,8,5,19,9,0,Matches
120,Antony,BRA,FW,Manchester Utd,Premier League,22,2000,20.0,22,9,9,9,4,8,28,28.6,20,18,0,18,11,33,6,0,Matches
121,Valentin Antov,BUL,DF,Monza,Serie A,21,2000,3.4,6,5,3,3,0,1,5,20.0,4,5,4,1,4,10,14,1,Matches
122,Christopher Antwi-Adjei,GHA,"FW,MF",Bochum,Bundesliga,28,1994,22.0,23,15,7,8,8,10,29,34.5,19,17,0,17,5,28,16,0,Matches
123,Anuar,MAR,"MF,FW",Valladolid,La Liga,27,1995,2.3,4,4,0,1,3,0,0,0.0,0,5,2,3,3,7,3,0,Matches
124,Houssem Aouar,ALG,MF,Lyon,Ligue 1,24,1998,5.8,12,5,5,5,2,3,9,33.3,6,12,2,10,8,20,3,0,Matches
125,Adil Aouchiche,FRA,MF,Lorient,Ligue 1,20,2002,2.8,5,2,3,1,1,1,9,11.1,8,1,0,1,4,9,1,0,Matches
126,Dennis Appiah,FRA,"DF,MF",Nantes,Ligue 1,30,1992,8.8,21,11,14,7,0,10,27,37.0,17,13,5,8,10,31,16,0,Matches
127,Stredair Appuah,FRA,"DF,MF",Nantes,Ligue 1,18,2004,0.7,2,1,0,2,0,0,0,0.0,0,2,0,2,1,3,0,0,Matches
128,Mauro Arambarri,URU,MF,Getafe,La Liga,26,1995,11.0,14,6,9,4,1,3,17,17.6,14,17,5,12,14,28,19,0,Matches
129,Charles Aránguiz,CHI,MF,Leverkusen,Bundesliga,33,1989,5.5,17,7,7,10,0,12,20,60.0,8,4,0,4,7,24,4,0,Matches
130,Ronald Araújo,URU,DF,Barcelona,La Liga,23,1999,20.0,26,18,12,13,1,6,9,66.7,3,15,7,8,12,38,41,1,Matches
131,Cameron Archer,ENG,"FW,MF",Aston Villa,Premier League,21,2001,0.5,0,0,0,0,0,0,0,0.0,0,0,0,0,0,0,0,0,Matches
132,Taïryk Arconte,FRA,FW,Brest,Ligue 1,18,2003,1.4,1,1,0,0,1,0,3,0.0,3,1,0,1,0,1,2,0,Matches
133,Alphonse Areola,FRA,GK,West Ham,Premier League,29,1993,3.4,0,0,0,0,0,0,0,0.0,0,0,0,0,0,0,0,0,Matches
134,Adu Ares,ESP,"FW,MF",Athletic Club,La Liga,20,2001,0.9,4,2,2,1,1,4,4,100.0,0,1,0,1,2,6,1,0,Matches
135,Joe Aribo,NGA,"MF,FW",Southampton,Premier League,26,1996,13.6,31,20,15,12,4,11,20,55.0,9,14,1,13,10,41,11,0,Matches
136,Adam Armstrong,ENG,"FW,MF",Southampton,Premier League,25,1997,14.8,14,9,6,5,3,3,10,30.0,7,15,3,12,5,19,6,0,Matches
137,Stuart Armstrong,SCO,"MF,FW",Southampton,Premier League,30,1992,15.6,32,21,15,13,4,14,39,35.9,25,18,0,18,10,42,9,1,Matches
138,Marko Arnautović,AUT,FW,Bologna,Serie A,33,1989,17.0,9,6,2,5,2,1,6,16.7,5,11,1,10,2,11,10,0,Matches
139,Maximilian Arnold,GER,MF,Wolfsburg,Bundesliga,28,1994,30.7,62,31,25,28,9,28,54,51.9,26,34,11,23,26,88,65,2,Matches
140,Mohamed El Arouch,FRA,MF,Lyon,Ligue 1,18,2004,0.0,1,1,1,0,0,0,0,0.0,0,0,0,0,0,1,0,0,Matches
141,Sergio Arribas,ESP,"MF,FW",Real Madrid,La Liga,20,2001,0.2,0,0,0,0,0,0,0,0.0,0,1,0,1,0,0,0,0,Matches
142,Kepa Arrizabalaga,ESP,GK,Chelsea,Premier League,27,1994,28.5,2,2,2,0,0,2,3,66.7,1,0,0,0,1,3,16,2,Matches
143,Roberto Arroyo,ESP,MF,Valladolid,La Liga,18,2003,0.2,1,1,0,1,0,1,1,100.0,0,0,0,0,0,1,0,0,Matches
144,Tolgay Arslan,GER,MF,Udinese,Serie A,31,1990,13.5,29,18,13,15,1,14,39,35.9,25,19,0,19,12,41,9,1,Matches
145,Ricard Artero,ESP,"MF,FW",Girona,La Liga,19,2003,1.5,3,3,2,1,0,1,1,100.0,0,2,0,2,1,4,3,0,Matches
146,Arthur,BRA,FW,Fiorentina,Serie A,24,1998,15.9,9,2,1,4,4,4,8,50.0,4,10,1,9,1,10,12,0,Matches
147,Santiago Arzamendia,PAR,"DF,MF",Cádiz,La Liga,24,1998,5.4,9,8,7,1,1,6,21,28.6,15,11,1,10,2,11,15,1,Matches
148,Takuma Asano,JPN,"FW,MF",Bochum,Bundesliga,27,1994,19.0,14,9,4,4,6,7,16,43.8,9,17,1,16,8,22,8,0,Matches
149,Santiago Ascacíbar,ARG,MF,Cremonese,Serie A,25,1997,8.1,29,14,17,10,2,14,35,40.0,21,14,2,12,13,42,11,0,Matches
150,Sergio Asenjo,ESP,GK,Valladolid,La Liga,33,1989,10.0,0,0,0,0,0,0,0,0.0,0,0,0,0,0,0,10,2,Matches
151,Marco Asensio,ESP,"FW,MF",Real Madrid,La Liga,26,1996,16.0,16,10,8,6,2,8,19,42.1,11,8,3,5,5,21,4,0,Matches
152,Kristoffer Askildsen,NOR,MF,Lecce,Serie A,21,2001,8.1,7,3,2,3,2,4,10,40.0,6,15,4,11,11,18,6,0,Matches
153,Fisnik Asllani,KVX,FW,Hoffenheim,Bundesliga,19,2002,1.9,0,0,0,0,0,0,4,0.0,4,2,0,2,3,3,3,0,Matches
154,Kristjan Asllani,ALB,MF,Inter,Serie A,20,2002,6.6,11,5,1,8,2,7,10,70.0,3,3,1,2,6,17,4,0,Matches
155,Iago Aspas,ESP,FW,Celta Vigo,La Liga,34,1987,31.9,8,4,0,4,4,3,22,13.6,19,10,1,9,7,15,23,0,Matches
156,Lorenz Assignon,TOG,DF,Rennes,Ligue 1,22,2000,2.9,6,2,4,2,0,2,4,50.0,2,6,0,6,2,8,9,0,Matches
157,Youcef Atal,ALG,"DF,MF",Nice,Ligue 1,26,1996,8.7,38,22,18,15,5,23,32,71.9,9,9,0,9,14,52,13,0,Matches
158,Valentin Atangana Edoa,FRA,MF,Reims,Ligue 1,16,2005,1.9,8,3,4,2,2,3,6,50.0,3,2,1,1,0,8,1,0,Matches
159,Pierre-Emerick Aubameyang,GAB,FW,Chelsea,Premier League,33,1989,6.2,1,0,1,0,0,0,1,0.0,1,2,0,2,2,3,4,2,Matches
160,Pierre-Emerick Aubameyang,GAB,FW,Barcelona,La Liga,33,1989,0.1,0,0,0,0,0,0,0,0.0,0,0,0,0,0,0,0,0,Matches
161,Emil Audero,ITA,GK,Sampdoria,Serie A,25,1997,25.0,0,0,0,0,0,0,2,0.0,2,0,0,0,0,0,7,1,Matches
162,Tommaso Augello,ITA,DF,Sampdoria,Serie A,27,1994,34.0,17,14,13,2,2,9,20,45.0,11,23,7,16,17,34,61,1,Matches
163,Ludwig Augustinsson,SWE,DF,Aston Villa,Premier League,28,1994,0.9,1,1,1,0,0,0,0,0.0,0,0,0,0,0,1,1,0,Matches
164,Ludwig Augustinsson,SWE,DF,Mallorca,La Liga,28,1994,1.5,2,1,2,0,0,1,3,33.3,2,1,0,1,1,3,3,0,Matches
165,Serge Aurier,CIV,DF,Nott'ham Forest,Premier League,29,1992,21.6,64,41,41,18,5,23,33,69.7,10,34,11,23,29,93,75,0,Matches
166,Mathias Autret,FRA,"MF,FW",Auxerre,Ligue 1,31,1991,14.3,22,10,10,10,2,7,16,43.8,9,14,2,12,12,34,13,0,Matches
167,Ezequiel Ávila,ARG,"FW,MF",Osasuna,La Liga,28,1994,19.0,8,5,2,4,2,6,23,26.1,17,12,1,11,8,16,16,0,Matches
168,Cédric Avinel,GLP,DF,Ajaccio,Ligue 1,35,1986,19.9,13,7,8,5,0,8,12,66.7,4,20,13,7,15,28,91,1,Matches
169,Taiwo Awoniyi,NGA,FW,Nott'ham Forest,Premier League,24,1997,15.6,17,10,2,10,5,6,10,60.0,4,18,4,14,4,21,20,0,Matches
170,Yasin Ayari,SWE,MF,Brighton,Premier League,18,2003,0.7,2,2,1,1,0,0,4,0.0,4,1,0,1,0,2,0,0,Matches
171,Mehmet Aydin,GER,"DF,FW",Schalke 04,Bundesliga,20,2002,6.3,25,18,14,9,2,11,24,45.8,13,11,0,11,10,35,15,0,Matches
172,André Ayew,GHA,"FW,MF",Nott'ham Forest,Premier League,32,1989,3.5,5,3,0,4,1,2,4,50.0,2,6,1,5,0,5,7,0,Matches
173,Jordan Ayew,GHA,"FW,MF",Crystal Palace,Premier League,30,1991,30.2,66,41,23,20,23,21,53,39.6,32,35,4,31,15,81,31,0,Matches
174,Kaan Ayhan,TUR,DF,Sassuolo,Serie A,27,1994,6.1,10,4,6,4,0,7,7,100.0,0,5,4,1,5,15,26,1,Matches
175,Luke Ayling,ENG,DF,Leeds United,Premier League,30,1991,22.8,66,37,42,15,9,42,85,49.4,43,34,11,23,26,92,52,2,Matches
176,Ayman Azhil,MAR,MF,Leverkusen,Bundesliga,21,2001,0.0,0,0,0,0,0,0,0,0.0,0,0,0,0,0,0,0,0,Matches
177,Sardar Azmoun,IRN,"FW,MF",Leverkusen,Bundesliga,27,1995,10.3,6,3,1,4,1,1,7,14.3,6,4,0,4,2,8,14,0,Matches
178,César Azpilicueta,ESP,DF,Chelsea,Premier League,32,1989,17.0,43,25,23,15,5,22,37,59.5,15,26,5,21,19,62,54,1,Matches
179,Sanoussy Ba,GER,DF,RB Leipzig,Bundesliga,18,2004,0.0,0,0,0,0,0,0,0,0.0,0,0,0,0,0,0,0,0,Matches
180,Iddrisu Baba,GHA,"MF,DF",Mallorca,La Liga,26,1996,18.9,31,17,15,16,0,15,32,46.9,17,18,8,10,11,42,39,0,Matches
181,Srđan Babić,SRB,DF,Almería,La Liga,26,1996,33.3,28,18,20,8,0,15,32,46.9,17,34,22,12,29,57,124,1,Matches
182,Loïc Bade,FRA,DF,Sevilla,La Liga,22,2000,16.1,27,20,23,3,1,17,30,56.7,13,21,13,8,23,50,77,0,Matches
183,Loïc Bade,FRA,DF,Rennes,Ligue 1,22,2000,1.0,1,1,1,0,0,0,0,0.0,0,0,0,0,1,2,3,0,Matches
184,Édgar Badía,ESP,GK,Elche,La Liga,30,1992,36.0,1,0,1,0,0,1,2,50.0,1,0,0,0,0,1,19,3,Matches
185,Benoît Badiashile,FRA,DF,Chelsea,Premier League,21,2001,10.1,14,8,10,4,0,9,14,64.3,5,5,2,3,16,30,34,1,Matches
186,Benoît Badiashile,FRA,DF,Monaco,Ligue 1,21,2001,9.3,10,8,6,4,0,5,10,50.0,5,9,6,3,17,27,40,1,Matches
187,Alex Baena,ESP,"MF,FW",Villarreal,La Liga,21,2001,21.6,30,17,9,15,6,15,45,33.3,30,15,3,12,7,37,16,0,Matches
188,Jaime Báez,URU,DF,Cremonese,Serie A,27,1995,1.1,4,2,3,0,1,3,6,50.0,3,0,0,0,0,4,2,1,Matches
189,Leon Bailey,JAM,"FW,MF",Aston Villa,Premier League,24,1997,21.9,14,6,6,7,1,5,20,25.0,15,13,0,13,6,20,12,0,Matches
190,Eric Bailly,CIV,DF,Marseille,Ligue 1,28,1994,6.0,13,10,6,6,1,7,7,100.0,0,15,12,3,12,25,18,1,Matches
191,Dénys Bain,FRA,DF,Auxerre,Ligue 1,29,1993,1.4,4,3,3,1,0,1,2,50.0,1,2,1,1,2,6,4,0,Matches
192,Brandon Baiye,BEL,MF,Clermont Foot,Ligue 1,21,2000,0.6,3,2,2,1,0,2,3,66.7,1,1,0,1,1,4,3,0,Matches
193,Stefan Bajcetic,ESP,MF,Liverpool,Premier League,17,2004,5.8,9,6,5,3,1,8,27,29.6,19,7,0,7,9,18,4,0,Matches
194,Nedim Bajrami,ALB,"MF,FW",Empoli,Serie A,23,1999,10.4,8,4,3,3,2,4,6,66.7,2,5,0,5,7,15,4,0,Matches
195,Nedim Bajrami,ALB,"FW,MF",Sassuolo,Serie A,23,1999,9.1,12,7,6,2,4,5,11,45.5,6,9,1,8,7,19,6,0,Matches
196,Cédric Bakambu,COD,MF,Marseille,Ligue 1,31,1991,0.7,2,1,2,0,0,2,2,100.0,0,0,0,0,0,2,0,0,Matches
197,Tiemoué Bakayoko,FRA,MF,Milan,Serie A,27,1994,0.5,5,5,4,1,0,3,3,100.0,0,0,0,0,0,5,0,1,Matches
198,Mitchel Bakker,NED,"DF,MF",Leverkusen,Bundesliga,22,2000,18.4,16,8,9,7,0,6,15,40.0,9,20,2,18,15,31,20,2,Matches
199,Ridle Baku,GER,"DF,FW",Wolfsburg,Bundesliga,24,1998,28.7,50,26,29,17,4,32,58,55.2,26,44,6,38,21,71,59,0,Matches
200,Tommaso Baldanzi,ITA,MF,Empoli,Serie A,19,2003,19.7,25,12,9,13,3,7,32,21.9,25,21,1,20,2,27,5,0,Matches
201,Alejandro Balde,ESP,DF,Barcelona,La Liga,18,2003,27.5,42,30,22,16,4,24,41,58.5,17,25,3,22,12,54,17,1,Matches
202,Thierno Balde,FRA,"DF,MF",Troyes,Ligue 1,20,2002,23.9,27,14,19,4,4,18,30,60.0,12,15,3,12,23,50,39,0,Matches
203,Carlos Baleba,CMR,MF,Lille,Ligue 1,18,2004,5.3,13,11,2,9,2,9,14,64.3,5,13,3,10,1,14,3,2,Matches
204,Mikel Balenziaga,ESP,DF,Athletic Club,La Liga,34,1988,1.3,4,4,1,2,1,4,4,100.0,0,0,0,0,1,5,2,0,Matches
205,Leonardo Balerdi,ARG,DF,Marseille,Ligue 1,23,1999,29.3,57,37,43,12,2,32,45,71.1,13,48,29,19,63,120,91,1,Matches
206,Dominic Ballard,ENG,"FW,MF",Southampton,Premier League,17,2005,0.3,0,0,0,0,0,0,0,0.0,0,0,0,0,1,1,0,0,Matches
207,Iván Balliu,ALB,DF,Rayo Vallecano,La Liga,30,1992,35.9,52,29,26,20,6,18,30,60.0,12,26,3,23,25,77,72,1,Matches
208,Fodé Ballo-Touré,SEN,DF,Milan,Serie A,25,1997,5.8,14,9,7,6,1,7,10,70.0,3,11,3,8,2,16,3,0,Matches
209,Folarin Balogun,USA,FW,Reims,Ligue 1,21,2001,33.3,9,5,1,5,3,2,20,10.0,18,20,1,19,3,12,15,0,Matches
210,Abdoulaye Bamba,CIV,DF,Angers,Ligue 1,32,1990,15.2,22,12,15,5,2,16,19,84.2,3,7,3,4,18,40,38,0,Matches
211,Jonathan Bamba,CIV,FW,Lille,Ligue 1,26,1996,30.9,37,17,12,14,11,14,45,31.1,31,36,1,35,22,59,14,0,Matches
212,Patrick Bamford,ENG,FW,Leeds United,Premier League,28,1993,16.8,9,6,0,6,3,4,20,20.0,16,12,5,7,5,14,13,0,Matches
213,Lameck Banda,ZAM,"FW,MF",Lecce,Serie A,21,2001,18.2,30,20,13,14,3,15,41,36.6,26,24,2,22,8,38,5,0,Matches
214,Filippo Bandinelli,ITA,MF,Empoli,Serie A,27,1995,25.1,55,34,19,26,10,17,45,37.8,28,20,7,13,18,73,40,0,Matches
215,Léo Baptistão,BRA,"FW,MF",Almería,La Liga,29,1992,19.2,32,20,13,16,3,13,33,39.4,20,17,2,15,19,51,12,0,Matches
216,Shandon Baptiste,GRN,MF,Brentford,Premier League,24,1998,6.9,15,9,6,6,3,7,17,41.2,10,10,2,8,7,22,10,0,Matches
217,Antonín Barák,CZE,MF,Hellas Verona,Serie A,27,1994,0.3,0,0,0,0,0,0,0,0.0,0,0,0,0,0,0,0,0,Matches
218,Antonín Barák,CZE,MF,Fiorentina,Serie A,27,1994,20.0,21,9,5,7,9,6,16,37.5,10,16,2,14,3,24,13,0,Matches
219,Andrea Barberis,ITA,MF,Monza,Serie A,28,1993,3.8,7,2,4,3,0,5,11,45.5,6,0,0,0,8,15,1,0,Matches
220,Tommaso Barbieri,ITA,DF,Juventus,Serie A,19,2002,1.2,3,3,3,0,0,3,8,37.5,5,3,0,3,0,3,2,0,Matches
221,Bradley Barcola,FRA,"FW,MF",Lyon,Ligue 1,19,2002,16.0,25,16,8,10,7,8,39,20.5,31,29,0,29,19,44,10,0,Matches
222,Melvin Bard,FRA,DF,Nice,Ligue 1,21,2000,27.3,96,60,61,29,6,59,89,66.3,30,35,4,31,64,160,40,1,Matches
223,Francesco Bardi,ITA,GK,Bologna,Serie A,30,1992,1.0,0,0,0,0,0,0,0,0.0,0,0,0,0,0,0,0,0,Matches
224,Keidi Bare,ALB,MF,Espanyol,La Liga,24,1997,5.6,15,8,7,5,3,7,13,53.8,6,8,2,6,11,26,8,0,Matches
225,Nicolò Barella,ITA,MF,Inter,Serie A,25,1997,29.0,49,25,17,26,6,28,53,52.8,25,29,5,24,12,61,12,0,Matches
226,Kike Barja,ESP,"FW,MF",Osasuna,La Liga,25,1997,14.6,15,9,6,5,4,8,24,33.3,16,7,0,7,4,19,3,0,Matches
227,Ross Barkley,ENG,"MF,FW",Nice,Ligue 1,28,1993,10.7,16,9,7,4,5,7,13,53.8,6,7,2,5,8,24,6,0,Matches
228,Aymen Barkok,MAR,MF,Mainz 05,Bundesliga,24,1998,6.5,18,8,10,5,3,5,10,50.0,5,7,0,7,3,21,9,0,Matches
229,Harvey Barnes,ENG,"FW,MF",Leicester City,Premier League,24,1997,30.1,26,14,8,14,4,14,42,33.3,28,32,1,31,8,34,12,0,Matches
230,Leandro Barreiro Martins,LUX,MF,Mainz 05,Bundesliga,22,2000,23.8,60,38,19,28,13,22,49,44.9,27,38,13,25,41,101,39,1,Matches
231,Enzo Barrenechea,ARG,MF,Juventus,Serie A,21,2001,1.8,8,3,3,4,1,3,5,60.0,2,3,0,3,2,10,3,0,Matches
232,Ander Barrenetxea,ESP,"FW,DF",Real Sociedad,La Liga,20,2001,9.8,21,15,15,6,0,12,28,42.9,16,15,1,14,5,26,7,0,Matches
233,Mickaël Barreto,FRA,MF,Ajaccio,Ligue 1,31,1991,14.7,32,20,12,17,3,8,45,17.8,37,17,0,17,18,50,11,0,Matches
234,Pablo Barrios,ESP,MF,Atlético Madrid,La Liga,19,2003,8.0,19,10,3,10,6,8,15,53.3,7,12,2,10,9,28,6,1,Matches
235,Musa Barrow,GAM,"FW,MF",Bologna,Serie A,23,1998,21.8,21,4,10,6,5,8,14,57.1,6,25,1,24,1,22,7,0,Matches
236,Federico Baschirotto,ITA,DF,Lecce,Serie A,25,1996,37.0,40,30,35,5,0,22,36,61.1,14,45,29,16,36,76,192,0,Matches
237,Toma Bašić,CRO,MF,Lazio,Serie A,25,1996,5.7,6,4,4,1,1,3,8,37.5,5,9,0,9,7,13,8,0,Matches
238,Alberto Basso,ITA,MF,Cremonese,Serie A,18,2004,0.2,0,0,0,0,0,0,0,0.0,0,0,0,0,0,0,0,0,Matches
239,Gil Bastião Dias,POR,FW,Stuttgart,Bundesliga,25,1996,4.4,8,6,3,4,1,3,12,25.0,9,7,0,7,2,10,3,0,Matches
240,Alessandro Bastoni,ITA,DF,Inter,Serie A,23,1999,24.0,41,20,20,14,7,11,27,40.7,16,27,13,14,24,65,45,0,Matches
241,Simone Bastoni,ITA,"MF,DF",Spezia,Serie A,25,1996,13.2,47,24,23,19,5,15,33,45.5,18,20,5,15,8,55,14,0,Matches
242,Rodrigo Battaglia,ARG,MF,Mallorca,La Liga,31,1991,7.6,12,5,7,5,0,6,14,42.9,8,16,7,9,5,17,18,0,Matches
243,Maximilian Bauer,GER,DF,Augsburg,Bundesliga,22,2000,20.5,31,17,18,12,1,17,34,50.0,17,25,9,16,23,54,79,1,Matches
244,Oliver Baumann,GER,GK,Hoffenheim,Bundesliga,32,1990,34.0,0,0,0,0,0,0,0,0.0,0,0,0,0,0,0,15,1,Matches
245,Timo Baumgartl,GER,DF,Union Berlin,Bundesliga,26,1996,6.2,11,6,5,4,2,5,18,27.8,13,12,4,8,2,13,14,0,Matches
246,Julian Baumgartlinger,AUT,MF,Augsburg,Bundesliga,34,1988,6.2,15,4,5,6,4,6,19,31.6,13,4,2,2,4,19,15,0,Matches
247,Christoph Baumgartner,AUT,"MF,FW",Hoffenheim,Bundesliga,22,1999,28.5,36,19,12,17,7,9,52,17.3,43,57,5,52,15,51,19,1,Matches
248,Cyrille Bayala,BFA,MF,Ajaccio,Ligue 1,26,1996,22.3,53,37,16,20,17,23,47,48.9,24,20,3,17,25,78,21,0,Matches
249,Brian Bayeye,FRA,DF,Torino,Serie A,22,2000,0.7,3,0,3,0,0,1,1,100.0,0,1,1,0,1,4,2,0,Matches
250,Noah Joel Sarenren Bazee,NGA,"MF,FW",Augsburg,Bundesliga,25,1996,0.2,0,0,0,0,0,0,1,0.0,1,1,0,1,0,0,0,0,Matches
251,Gavin Bazunu,IRL,GK,Southampton,Premier League,20,2002,32.0,1,0,1,0,0,1,1,100.0,0,0,0,0,1,2,24,2,Matches
252,Bebé,CPV,FW,Rayo Vallecano,La Liga,32,1990,0.7,0,0,0,0,0,0,2,0.0,2,1,0,1,0,0,0,0,Matches
253,Ihlas Bebou,TOG,"FW,DF",Hoffenheim,Bundesliga,28,1994,15.7,19,16,8,7,4,11,17,64.7,6,9,2,7,7,26,15,0,Matches
254,Rodrigo Becão,BRA,DF,Udinese,Serie A,26,1996,27.6,70,36,50,17,3,40,53,75.5,13,44,24,20,26,96,68,2,Matches
255,Mads Bech Sørensen,DEN,"DF,MF",Brentford,Premier League,23,1999,0.2,0,0,0,0,0,0,0,0.0,0,0,0,0,1,1,1,0,Matches
256,Julius Beck,DEN,MF,Spezia,Serie A,17,2005,0.1,2,1,1,1,0,0,0,0.0,0,0,0,0,0,2,0,0,Matches
257,Sheraldo Becker,SUR,FW,Union Berlin,Bundesliga,27,1995,28.4,15,5,1,7,7,2,11,18.2,9,13,1,12,3,18,7,1,Matches
258,Jan Bednarek,POL,DF,Southampton,Premier League,26,1996,18.6,27,21,20,7,0,12,16,75.0,4,38,27,11,49,76,87,0,Matches
259,Jan Bednarek,POL,DF,Aston Villa,Premier League,26,1996,1.1,3,3,0,3,0,1,1,100.0,0,3,1,2,2,5,5,0,Matches
260,Donny van de Beek,NED,MF,Manchester Utd,Premier League,25,1997,1.9,0,0,0,0,0,0,1,0.0,1,2,1,1,1,1,1,0,Matches
261,Asmir Begović,BIH,GK,Everton,Premier League,35,1987,1.0,0,0,0,0,0,0,0,0.0,0,0,0,0,0,0,1,0,Matches
262,Yanis Begraoui,MAR,"FW,MF",Toulouse,Ligue 1,21,2001,0.7,2,0,1,0,1,1,2,50.0,1,0,0,0,1,3,0,0,Matches
263,Kevin Behrens,GER,FW,Union Berlin,Bundesliga,31,1991,17.1,11,7,4,4,3,4,18,22.2,14,18,3,15,5,16,25,0,Matches
264,Alexis Beka Beka,FRA,"MF,DF",Nice,Ligue 1,21,2001,6.1,16,5,6,9,1,4,15,26.7,11,9,1,8,12,28,6,0,Matches
265,Jérémie Bela,ANG,"DF,MF",Clermont Foot,Ligue 1,29,1993,8.3,6,4,2,1,3,3,4,75.0,1,10,1,9,9,15,8,0,Matches
266,Reda Belahyane,FRA,MF,Nice,Ligue 1,18,2004,2.0,8,6,5,3,0,3,5,60.0,2,5,1,4,2,10,0,0,Matches
267,Youcef Belaïli,ALG,"MF,FW",Ajaccio,Ligue 1,30,1992,12.8,18,10,3,9,6,8,20,40.0,12,10,1,9,5,23,4,0,Matches
268,Youcef Belaïli,ALG,"FW,MF",Brest,Ligue 1,30,1992,4.0,5,2,3,2,0,2,7,28.6,5,2,0,2,1,6,1,0,Matches
269,Haris Belkebla,ALG,MF,Brest,Ligue 1,28,1994,29.5,80,48,35,40,5,44,85,51.8,41,32,6,26,52,132,21,3,Matches
270,Stefan Bell,GER,DF,Mainz 05,Bundesliga,30,1991,26.6,43,28,32,10,1,22,44,50.0,22,42,15,27,44,87,133,0,Matches
271,Armel Bella Kotchap,GER,DF,Southampton,Premier League,20,2001,20.9,37,17,28,9,0,15,20,75.0,5,29,12,17,44,81,110,0,Matches
272,Raoul Bellanova,ITA,DF,Inter,Serie A,22,2000,5.5,14,6,11,2,1,9,14,64.3,5,6,1,5,4,18,14,0,Matches
273,Karim Bellarabi,GER,"FW,MF",Leverkusen,Bundesliga,32,1990,0.9,2,0,1,1,0,2,3,66.7,1,0,0,0,0,2,0,0,Matches
274,Jean-Ricner Bellegarde,FRA,"MF,FW",Strasbourg,Ligue 1,24,1998,26.9,47,25,15,21,11,11,25,44.0,14,26,3,23,26,73,22,0,Matches
275,Héctor Bellerín,ESP,DF,Barcelona,La Liga,27,1995,1.6,2,0,0,2,0,2,3,66.7,1,2,0,2,3,5,2,0,Matches
276,Jude Bellingham,ENG,MF,Dortmund,Bundesliga,19,2003,29.9,76,42,28,34,14,34,51,66.7,17,51,4,47,35,111,30,0,Matches
277,Jeanöel Belocian,FRA,DF,Rennes,Ligue 1,17,2005,5.6,10,7,3,5,2,5,9,55.6,4,6,3,3,6,16,11,0,Matches
278,Andrea Belotti,ITA,FW,Roma,Serie A,28,1993,12.7,12,5,3,5,4,5,11,45.5,6,11,1,10,3,15,5,0,Matches
279,Fran Beltrán,ESP,MF,Celta Vigo,La Liga,23,1999,31.7,34,22,15,14,5,14,55,25.5,41,29,5,24,53,87,35,2,Matches
280,Eliesse Ben Seghir,FRA,"FW,MF",Monaco,Ligue 1,17,2005,11.7,18,10,4,12,2,4,12,33.3,8,18,1,17,4,22,1,0,Matches
281,Salim Ben Seghir,FRA,MF,Marseille,Ligue 1,19,2003,0.0,0,0,0,0,0,0,0,0.0,0,1,0,1,0,0,0,0,Matches
282,Wissam Ben Yedder,FRA,FW,Monaco,Ligue 1,31,1990,23.5,16,9,2,5,9,4,13,30.8,9,15,0,15,4,20,0,0,Matches
283,Marco Benassi,ITA,DF,Fiorentina,Serie A,27,1994,1.0,3,3,2,0,1,3,4,75.0,1,0,0,0,1,4,1,0,Matches
284,Marco Benassi,ITA,MF,Cremonese,Serie A,27,1994,11.1,26,15,9,11,6,15,24,62.5,9,13,1,12,12,38,19,0,Matches
285,Iker Benito,ESP,"FW,MF",Osasuna,La Liga,19,2002,2.0,4,3,0,3,1,2,4,50.0,2,0,0,0,2,6,4,0,Matches
286,Ismaël Bennacer,ALG,MF,Milan,Serie A,24,1997,22.3,59,33,26,31,2,30,51,58.8,21,25,7,18,26,85,16,1,Matches
287,Saïd Benrahma,ALG,"FW,MF",West Ham,Premier League,26,1995,23.0,25,15,11,7,7,11,27,40.7,16,23,1,22,9,34,13,0,Matches
288,Ramy Bensebaini,ALG,DF,M'Gladbach,Bundesliga,27,1995,27.6,34,21,21,10,3,26,39,66.7,13,44,14,30,36,70,98,1,Matches
289,Nabil Bentaleb,ALG,MF,Angers,Ligue 1,27,1994,27.7,74,40,31,35,8,36,61,59.0,25,33,11,22,44,118,29,3,Matches
290,Rodrigo Bentancur,URU,MF,Tottenham,Premier League,25,1997,16.7,45,28,15,21,9,16,28,57.1,12,28,15,13,20,65,22,0,Matches
291,Daniel Bentley,ENG,GK,Wolves,Premier League,29,1993,2.0,1,1,1,0,0,1,1,100.0,0,0,0,0,0,1,0,0,Matches
292,Karim Benzema,FRA,FW,Real Madrid,La Liga,34,1987,22.6,9,5,2,4,3,2,11,18.2,9,11,0,11,2,11,5,0,Matches
293,Domenico Berardi,ITA,FW,Sassuolo,Serie A,27,1994,20.7,23,14,8,10,5,9,40,22.5,31,13,0,13,19,42,18,0,Matches
294,Yuri Berchiche,ESP,DF,Athletic Club,La Liga,32,1990,26.7,56,32,28,20,8,35,59,59.3,24,37,12,25,40,96,59,1,Matches
295,Álex Berenguer,ESP,FW,Athletic Club,La Liga,27,1995,25.5,58,37,17,25,16,23,60,38.3,37,37,4,33,10,68,6,0,Matches
296,Bartosz Bereszyński,POL,DF,Sampdoria,Serie A,30,1992,13.3,28,18,15,11,2,17,26,65.4,9,18,4,14,21,49,25,0,Matches
297,Bartosz Bereszyński,POL,DF,Napoli,Serie A,30,1992,1.8,3,2,1,1,1,2,2,100.0,0,4,0,4,3,6,3,0,Matches
298,Patrick Berg,NOR,"MF,FW",Lens,Ligue 1,24,1997,0.3,0,0,0,0,0,0,1,0.0,1,0,0,0,1,1,0,0,Matches
299,Mitchell van Bergen,NED,"FW,DF",Reims,Ligue 1,22,1999,10.1,18,8,6,7,5,8,20,40.0,12,8,2,6,6,24,11,0,Matches
300,Mergim Berisha,GER,FW,Augsburg,Bundesliga,24,1998,18.7,11,6,4,3,4,4,14,28.6,10,16,1,15,0,11,19,0,Matches
301,Quentin Bernard,FRA,DF,Auxerre,Ligue 1,33,1989,7.0,9,7,4,2,3,7,15,46.7,8,9,1,8,15,24,17,0,Matches
302,Paul Bernardoni,FRA,GK,Angers,Ligue 1,25,1997,27.0,2,0,2,0,0,2,3,66.7,1,1,0,1,1,3,12,1,Matches
303,Juan Bernat,ESP,"DF,MF",Paris S-G,Ligue 1,29,1993,18.3,32,16,18,9,5,21,39,53.8,18,11,2,9,9,41,22,1,Matches
304,Victor Bernth Kristiansen,DEN,DF,Leicester City,Premier League,19,2002,9.9,38,23,18,16,4,22,30,73.3,8,16,4,12,3,41,26,0,Matches
305,Jason Berthomier,FRA,MF,Clermont Foot,Ligue 1,32,1990,0.3,0,0,0,0,0,0,0,0.0,0,0,0,0,0,0,0,0,Matches
306,Marco Bertini,ITA,MF,Lazio,Serie A,19,2002,0.0,0,0,0,0,0,0,0,0.0,0,0,0,0,0,0,0,0,Matches
307,Beto,GNB,FW,Udinese,Serie A,24,1998,23.7,16,9,0,9,7,4,17,23.5,13,18,3,15,6,22,30,0,Matches
308,Owen Bevan,WAL,DF,Bournemouth,Premier League,18,2003,0.1,0,0,0,0,0,0,0,0.0,0,0,0,0,0,0,0,0,Matches
309,Matteo Bianchetti,ITA,DF,Cremonese,Serie A,29,1993,23.7,32,19,21,9,2,20,32,62.5,12,31,17,14,20,52,111,0,Matches
310,Alessandro Bianco,ITA,MF,Fiorentina,Serie A,19,2002,1.7,5,2,2,3,0,2,3,66.7,1,1,0,1,0,5,0,0,Matches
311,Giulian Biancone,FRA,DF,Nott'ham Forest,Premier League,22,2000,0.2,2,1,2,0,0,1,1,100.0,0,0,0,0,1,3,0,0,Matches
312,Ermin Bičakčić,BIH,DF,Hoffenheim,Bundesliga,32,1990,2.9,8,4,6,1,1,2,6,33.3,4,4,3,1,5,13,14,0,Matches
313,Pedro Bigas,ESP,DF,Elche,La Liga,31,1990,22.4,37,20,30,7,0,18,29,62.1,11,25,14,11,33,70,95,0,Matches
314,Jaka Bijol,SVN,DF,Udinese,Serie A,23,1999,30.3,39,23,32,7,0,16,27,59.3,11,41,25,16,29,68,165,0,Matches
315,El Bilal Touré,MLI,FW,Almería,La Liga,20,2001,14.0,4,3,2,1,1,0,3,0.0,3,6,1,5,1,5,23,0,Matches
316,El Bilal Touré,MLI,FW,Reims,Ligue 1,20,2001,1.0,0,0,0,0,0,0,0,0.0,0,2,0,2,0,0,1,0,Matches
317,Philip Billing,DEN,"MF,FW",Bournemouth,Premier League,26,1996,30.7,63,36,21,33,9,11,40,27.5,29,48,8,40,31,94,58,1,Matches
318,Jean-Claude Billong,CMR,MF,Clermont Foot,Ligue 1,28,1993,0.3,0,0,0,0,0,0,0,0.0,0,1,1,0,1,1,0,0,Matches
319,Cristiano Biraghi,ITA,DF,Fiorentina,Serie A,29,1992,28.3,65,38,29,29,7,32,65,49.2,33,32,7,25,14,79,42,1,Matches
320,Samuele Birindelli,ITA,DF,Monza,Serie A,23,1999,15.6,35,19,21,10,4,18,29,62.1,11,28,8,20,16,51,30,0,Matches
321,Veljko Birmančević,SRB,"FW,MF",Toulouse,Ligue 1,24,1998,4.9,13,7,5,4,4,7,21,33.3,14,12,2,10,7,20,1,0,Matches
322,Tom Bischof,GER,"MF,FW",Hoffenheim,Bundesliga,17,2005,3.5,15,10,8,3,4,7,10,70.0,3,5,1,4,1,16,1,0,Matches
323,Yves Bissouma,MLI,MF,Tottenham,Premier League,25,1996,11.2,16,13,6,6,4,2,7,28.6,5,15,6,9,12,28,10,0,Matches
324,Kristijan Bistrović,CRO,MF,Lecce,Serie A,24,1998,5.1,3,1,3,0,0,0,5,0.0,5,3,0,3,0,3,4,0,Matches
325,Leonardo Bittencourt,GER,"MF,DF",Werder Bremen,Bundesliga,28,1993,18.1,53,28,20,25,8,25,62,40.3,37,13,0,13,10,63,15,0,Matches
326,Marco Bizot,NED,GK,Brest,Ligue 1,31,1991,37.0,0,0,0,0,0,0,1,0.0,1,1,0,1,0,0,24,4,Matches
327,Lautaro Blanco,ARG,"DF,MF",Elche,La Liga,23,1999,9.7,16,9,10,4,2,9,26,34.6,17,8,1,7,2,18,10,1,Matches
328,Rubén Blanco,ESP,GK,Marseille,Ligue 1,27,1995,5.5,0,0,0,0,0,0,0,0.0,0,0,0,0,0,0,1,0,Matches
329,Ludovic Blas,FRA,"MF,FW",Nantes,Ligue 1,24,1997,31.3,47,30,17,19,11,17,49,34.7,32,26,1,25,19,66,8,0,Matches
330,Janis Blaswich,GER,GK,RB Leipzig,Bundesliga,31,1991,26.0,0,0,0,0,0,0,0,0.0,0,0,0,0,0,0,10,0,Matches
331,Miha Blažič,SVN,DF,Angers,Ligue 1,29,1993,22.0,8,6,8,0,0,7,15,46.7,8,25,19,6,22,30,80,1,Matches
332,Joaquín Blázquez,ARG,GK,Brest,Ligue 1,21,2001,1.0,0,0,0,0,0,0,0,0.0,0,0,0,0,0,0,2,0,Matches
333,Alexis Blin,FRA,MF,Lecce,Serie A,25,1996,26.4,69,39,27,33,9,38,73,52.1,35,55,15,40,34,103,74,0,Matches
334,Daley Blind,NED,"DF,MF",Bayern Munich,Bundesliga,32,1990,1.5,2,0,2,0,0,0,1,0.0,1,4,2,2,2,4,6,0,Matches
335,Myron Boadu,NED,FW,Monaco,Ligue 1,21,2001,3.3,3,3,0,2,1,1,7,14.3,6,1,0,1,0,3,1,0,Matches
336,Jérôme Boateng,GER,DF,Lyon,Ligue 1,33,1988,4.8,3,0,2,1,0,2,6,33.3,4,8,5,3,6,9,16,0,Matches
337,Kevin-Prince Boateng,GHA,MF,Hertha BSC,Bundesliga,35,1987,5.2,8,6,4,2,2,3,9,33.3,6,11,3,8,3,11,5,0,Matches
338,Antonin Bobichon,FRA,MF,Angers,Ligue 1,26,1995,0.2,0,0,0,0,0,0,0,0.0,0,1,0,1,0,0,0,0,Matches
339,Jean-Paul Boëtius,NED,MF,Hertha BSC,Bundesliga,28,1994,11.7,30,16,19,9,2,8,25,32.0,17,25,5,20,14,44,10,0,Matches
340,Jeremie Boga,CIV,"MF,FW",Atalanta,Serie A,25,1997,8.7,9,5,3,2,4,2,5,40.0,3,6,0,6,1,10,1,0,Matches
341,Emil Bohinen,NOR,MF,Salernitana,Serie A,23,1999,9.2,25,13,15,8,2,12,23,52.2,11,25,7,18,17,42,21,0,Matches
342,Quentin Boisgard,FRA,MF,Lorient,Ligue 1,25,1997,2.0,6,2,1,4,1,3,4,75.0,1,3,1,2,4,10,2,0,Matches
343,Willy Boly,CIV,DF,Nott'ham Forest,Premier League,31,1991,7.6,13,6,8,3,2,8,13,61.5,5,13,4,9,12,25,45,0,Matches
344,Giacomo Bonaventura,ITA,MF,Fiorentina,Serie A,32,1989,21.2,35,23,14,15,6,24,37,64.9,13,14,0,14,16,51,5,1,Matches
345,Federico Bonazzoli,ITA,"FW,MF",Salernitana,Serie A,25,1997,12.4,5,3,0,3,2,0,9,0.0,9,9,1,8,3,8,0,0,Matches
346,Warren Bondo,FRA,MF,Monza,Serie A,18,2003,0.7,1,0,1,0,0,0,0,0.0,0,1,0,1,0,1,0,0,Matches
347,Theo Bongonda,COD,"MF,FW",Cádiz,La Liga,26,1995,21.5,28,20,11,14,3,17,40,42.5,23,21,2,19,6,34,14,0,Matches
348,Kevin Bonifazi,ITA,DF,Bologna,Serie A,26,1996,10.0,13,8,7,6,0,6,12,50.0,6,11,8,3,12,25,39,0,Matches
349,Leonardo Bonucci,ITA,DF,Juventus,Serie A,35,1987,9.8,5,4,1,4,0,2,4,50.0,2,12,8,4,13,18,29,0,Matches
350,Neto Borges,BRA,DF,Clermont Foot,Ligue 1,25,1996,31.5,75,45,45,20,10,46,75,61.3,29,45,11,34,41,116,62,1,Matches
351,Yvandro Borges Sanches,LUX,"FW,MF",M'Gladbach,Bundesliga,18,2004,0.3,2,2,0,2,0,2,2,100.0,0,0,0,0,0,2,0,0,Matches
352,Sebastiaan Bornauw,BEL,DF,Wolfsburg,Bundesliga,23,1999,21.4,29,17,17,10,2,16,22,72.7,6,27,12,15,31,60,83,1,Matches
353,Rafael Borré,COL,"MF,FW",Eint Frankfurt,Bundesliga,26,1995,12.0,25,15,4,13,8,4,17,23.5,13,10,2,8,2,27,9,0,Matches
354,Erik Botheim,NOR,"MF,FW",Salernitana,Serie A,22,2000,9.6,11,7,3,4,4,6,13,46.2,7,3,0,3,0,11,4,0,Matches
355,Sven Botman,NED,DF,Newcastle Utd,Premier League,22,2000,34.7,38,24,31,7,0,22,28,78.6,6,44,24,20,34,72,126,2,Matches
356,Kenji-Van Boto,MAD,DF,Auxerre,Ligue 1,26,1996,2.0,3,2,2,0,1,2,4,50.0,2,0,0,0,1,4,3,0,Matches
357,Kouamé Botué,BFA,"FW,MF",Ajaccio,Ligue 1,19,2002,2.5,4,2,2,1,1,0,2,0.0,2,1,0,1,0,4,1,0,Matches
358,Badredine Bouanani,ALG,"FW,MF",Nice,Ligue 1,17,2004,9.6,13,9,2,7,4,7,14,50.0,7,4,0,4,1,14,2,0,Matches
359,Hicham Boudaoui,ALG,MF,Nice,Ligue 1,22,1999,20.8,67,32,31,30,6,35,53,66.0,18,34,5,29,36,103,16,0,Matches
360,Franci Bouebari,FRA,DF,Strasbourg,Ligue 1,18,2003,0.8,3,0,1,2,0,3,5,60.0,2,0,0,0,2,5,2,0,Matches
361,Sofiane Boufal,MAR,"FW,MF",Angers,Ligue 1,28,1993,9.3,14,9,7,4,3,3,14,21.4,11,6,0,6,5,19,1,0,Matches
362,Yassine Bounou,MAR,GK,Sevilla,La Liga,31,1991,23.9,2,1,2,0,0,1,4,25.0,3,0,0,0,2,4,11,1,Matches
363,Ismaëlben Boura,FRA,"DF,FW",Lens,Ligue 1,21,2000,1.0,6,4,4,2,0,5,6,83.3,1,2,1,1,2,8,3,0,Matches
364,Mehdi Bourabia,MAR,MF,Spezia,Serie A,30,1991,30.8,41,20,13,22,6,19,41,46.3,22,39,12,27,32,73,57,0,Matches
365,Benjamin Bourigeaud,FRA,"MF,FW",Rennes,Ligue 1,28,1994,34.1,45,29,16,23,6,21,65,32.3,44,38,3,35,31,76,32,0,Matches
366,Edoardo Bove,ITA,MF,Roma,Serie A,20,2002,11.0,35,18,12,15,8,16,39,41.0,23,15,1,14,10,45,11,0,Matches
367,Jarrod Bowen,ENG,"FW,MF",West Ham,Premier League,25,1996,35.9,39,16,14,11,14,16,57,28.1,41,47,9,38,36,75,25,0,Matches
368,Lucas Boyé,ARG,FW,Elche,La Liga,26,1996,27.4,36,16,12,16,8,17,35,48.6,18,33,5,28,15,51,46,0,Matches
369,Jayden Braaf,NED,"MF,FW",Hellas Verona,Serie A,19,2002,3.2,5,3,2,3,0,0,0,0.0,0,1,0,1,2,7,1,0,Matches
370,Domagoj Bradarić,CRO,DF,Salernitana,Serie A,22,1999,25.0,26,19,14,8,4,7,16,43.8,9,20,5,15,21,47,44,0,Matches
371,Bilal Brahimi,ALG,"FW,MF",Nice,Ligue 1,22,2000,8.9,8,5,2,5,1,1,7,14.3,6,4,0,4,4,12,0,0,Matches
372,Martin Braithwaite,DEN,"FW,MF",Espanyol,La Liga,31,1991,27.3,12,2,2,4,6,5,14,35.7,9,10,0,10,5,17,11,0,Matches
373,Juan Brandáriz,ESP,DF,Almería,La Liga,23,1999,16.5,29,16,18,9,2,14,23,60.9,9,20,7,13,15,44,53,0,Matches
374,Julian Brandt,GER,"MF,FW",Dortmund,Bundesliga,26,1996,26.6,29,20,6,14,9,12,43,27.9,31,23,0,23,15,44,9,1,Matches
375,Darko Brašanac,SRB,MF,Osasuna,La Liga,30,1992,11.6,29,20,12,10,7,12,23,52.2,11,14,2,12,12,41,9,0,Matches
376,Lilian Brassier,FRA,DF,Brest,Ligue 1,22,1999,34.4,42,30,31,8,3,23,32,71.9,9,42,19,23,53,95,132,1,Matches
377,Claudio Bravo,CHI,GK,Betis,La Liga,39,1983,12.0,0,0,0,0,0,0,0,0.0,0,0,0,0,2,2,1,1,Matches
378,Fabian Bredlow,GER,GK,Stuttgart,Bundesliga,27,1995,15.0,1,1,1,0,0,1,1,100.0,0,0,0,0,0,1,4,2,Matches
379,James Bree,ENG,DF,Southampton,Premier League,24,1997,4.1,5,3,4,1,0,3,4,75.0,1,3,1,2,6,11,11,0,Matches
380,Josip Brekalo,CRO,"FW,MF",Fiorentina,Serie A,24,1998,2.5,2,1,0,1,1,1,4,25.0,3,1,0,1,1,3,1,0,Matches
381,Josip Brekalo,CRO,"MF,FW",Wolfsburg,Bundesliga,24,1998,3.0,2,1,2,0,0,0,4,0.0,4,0,0,0,2,4,2,0,Matches
382,Gleison Bremer,BRA,DF,Juventus,Serie A,25,1997,29.3,29,20,23,5,1,19,26,73.1,7,44,22,22,42,71,120,2,Matches
383,Armando Broja,ALB,FW,Chelsea,Premier League,20,2001,3.3,4,1,0,3,1,1,1,100.0,0,10,1,9,1,5,1,0,Matches
384,Dylan Bronn,TUN,DF,Salernitana,Serie A,27,1995,18.7,34,18,17,16,1,20,30,66.7,10,32,20,12,20,54,58,1,Matches
385,David Brooks,WAL,"FW,MF",Bournemouth,Premier League,25,1997,1.9,1,0,1,0,0,0,1,0.0,1,2,0,2,2,3,5,0,Matches
386,John Brooks,USA,DF,Hoffenheim,Bundesliga,29,1993,15.0,18,12,10,8,0,13,18,72.2,5,17,12,5,10,28,105,0,Matches
387,Moritz Broschinski,GER,"FW,MF",Bochum,Bundesliga,21,2000,2.4,0,0,0,0,0,0,5,0.0,5,1,0,1,0,0,6,0,Matches
388,Marcelo Brozović,CRO,MF,Inter,Serie A,29,1992,19.7,37,22,13,22,2,11,37,29.7,26,23,7,16,22,59,28,0,Matches
389,Cédric Brunner,SUI,DF,Schalke 04,Bundesliga,28,1994,25.7,39,27,26,11,2,30,45,66.7,15,24,7,17,43,82,79,0,Matches
390,Lewis Brunt,ENG,DF,Leicester City,Premier League,21,2000,0.3,0,0,0,0,0,0,0,0.0,0,0,0,0,0,0,2,0,Matches
391,Jacob Bruun Larsen,DEN,FW,Hoffenheim,Bundesliga,23,1998,3.6,4,3,0,1,3,3,4,75.0,1,3,1,2,1,5,0,0,Matches
392,Andreas Bruus,DEN,"DF,FW",Troyes,Ligue 1,23,1999,18.1,12,6,9,3,0,8,20,40.0,12,13,2,11,17,29,24,0,Matches
393,Joe Bryan,ENG,"MF,DF",Nice,Ligue 1,28,1993,2.0,5,4,3,2,0,4,4,100.0,0,2,0,2,1,6,1,0,Matches
394,Lee Buchanan,ENG,"DF,FW",Werder Bremen,Bundesliga,21,2001,5.2,14,10,2,11,1,6,12,50.0,6,5,0,5,12,26,21,0,Matches
395,Ante Budimir,CRO,FW,Osasuna,La Liga,31,1991,20.0,19,9,0,12,7,2,10,20.0,8,10,0,10,5,24,19,0,Matches
396,Emi Buendía,ARG,"MF,FW",Aston Villa,Premier League,25,1996,26.8,52,23,20,20,12,21,74,28.4,53,20,2,18,20,72,17,0,Matches
397,Hugo Bueno,ESP,DF,Wolves,Premier League,19,2002,14.6,33,16,23,6,4,17,33,51.5,16,14,1,13,10,43,36,0,Matches
398,Santiago Bueno,URU,DF,Girona,La Liga,23,1998,33.4,63,38,43,19,1,24,36,66.7,12,34,22,12,31,94,105,2,Matches
399,Adam Buksa,POL,"FW,MF",Lens,Ligue 1,26,1996,1.1,1,0,0,0,1,0,3,0.0,3,0,0,0,0,1,0,0,Matches
400,Marius Bülter,GER,"FW,MF",Schalke 04,Bundesliga,29,1993,28.9,22,11,8,7,7,12,32,37.5,20,34,1,33,10,32,20,0,Matches
401,Cristian Buonaiuto,ITA,"MF,FW",Cremonese,Serie A,29,1992,10.9,25,16,8,11,6,12,26,46.2,14,11,0,11,14,39,7,0,Matches
402,Facundo Buonanotte,ARG,"FW,MF",Brighton,Premier League,17,2004,6.3,2,1,1,1,0,1,22,4.5,21,5,2,3,4,6,3,0,Matches
403,Alessandro Buongiorno,ITA,DF,Torino,Serie A,23,1999,30.2,38,25,22,16,0,16,31,51.6,15,38,19,19,60,98,105,2,Matches
404,Delano Burgzorg,NED,"FW,MF",Mainz 05,Bundesliga,23,1998,2.7,3,3,1,1,1,2,3,66.7,1,2,0,2,0,3,2,0,Matches
405,Jonathan Burkardt,GER,"MF,FW",Mainz 05,Bundesliga,22,2000,5.9,3,1,0,1,2,1,4,25.0,3,6,1,5,1,4,1,0,Matches
406,Oliver Burke,SCO,"FW,MF",Werder Bremen,Bundesliga,25,1997,3.0,1,0,0,0,1,0,0,0.0,0,2,0,2,0,1,0,0,Matches
407,Dan Burn,ENG,DF,Newcastle Utd,Premier League,30,1992,34.6,60,38,29,23,8,34,67,50.7,33,42,16,26,32,92,120,2,Matches
408,Maxime Busi,BEL,DF,Reims,Ligue 1,22,1999,11.6,21,16,9,11,1,13,29,44.8,16,14,6,8,14,35,24,0,Matches
409,Sergio Busquets,ESP,MF,Barcelona,La Liga,34,1988,26.0,58,26,24,26,8,29,51,56.9,22,32,6,26,27,85,36,2,Matches
410,Aurélio Buta,POR,DF,Eint Frankfurt,Bundesliga,25,1997,14.6,33,19,15,13,5,15,27,55.6,12,18,1,17,9,42,34,0,Matches
411,Leonardo Buta,POR,DF,Udinese,Serie A,20,2002,0.2,1,1,0,1,0,0,0,0.0,0,0,0,0,0,1,0,0,Matches
412,Marcin Bułka,POL,GK,Nice,Ligue 1,22,1999,2.0,0,0,0,0,0,0,1,0.0,1,0,0,0,1,1,0,0,Matches
413,Jamie Bynoe-Gittens,ENG,"FW,MF",Dortmund,Bundesliga,17,2004,5.9,8,4,2,5,1,2,7,28.6,5,1,0,1,1,9,2,0,Matches
414,Juan Cabal,COL,DF,Hellas Verona,Serie A,21,2001,4.9,10,6,7,3,0,7,12,58.3,5,8,5,3,13,23,12,0,Matches
415,Rémy Cabella,FRA,"MF,FW",Lille,Ligue 1,32,1990,28.1,64,37,21,28,15,29,64,45.3,35,41,5,36,17,81,7,1,Matches
416,Jimmy Cabot,FRA,"DF,MF",Lens,Ligue 1,28,1994,5.7,20,12,10,8,2,12,26,46.2,14,5,0,5,4,24,12,0,Matches
417,Leandro Cabrera,URU,DF,Espanyol,La Liga,31,1991,29.7,46,24,34,12,0,28,43,65.1,15,37,23,14,43,89,114,2,Matches
418,Liberato Cacace,NZL,DF,Empoli,Serie A,21,2000,6.5,25,10,12,8,5,9,15,60.0,6,15,7,8,4,29,16,0,Matches
419,Anthony Caci,FRA,DF,Mainz 05,Bundesliga,25,1997,22.6,58,33,32,20,6,28,42,66.7,14,28,4,24,54,112,40,0,Matches
420,Cafú,POR,MF,Nott'ham Forest,Premier League,29,1993,0.1,0,0,0,0,0,0,0,0.0,0,0,0,0,0,0,1,0,Matches
421,Moisés Caicedo,ECU,MF,Brighton,Premier League,20,2001,34.9,100,50,41,47,12,40,68,58.8,28,43,7,36,56,156,31,3,Matches
422,Tom Cairney,SCO,MF,Fulham,Premier League,31,1991,11.0,17,6,4,8,5,7,10,70.0,3,18,3,15,5,22,3,0,Matches
423,Jens Cajuste,SWE,MF,Reims,Ligue 1,22,1999,17.0,46,25,25,14,7,25,48,52.1,23,30,6,24,18,64,22,0,Matches
424,Cala,ESP,DF,Cádiz,La Liga,32,1989,1.5,2,1,1,1,0,1,2,50.0,1,2,1,1,1,3,12,0,Matches
425,Davide Calabria,ITA,DF,Milan,Serie A,25,1996,18.8,71,44,31,32,8,38,61,62.3,23,22,7,15,25,96,34,0,Matches
426,Mattia Caldara,ITA,DF,Spezia,Serie A,28,1994,13.9,23,14,10,11,2,9,20,45.0,11,23,16,7,17,40,88,2,Matches
427,Luca Caldirola,ITA,DF,Monza,Serie A,31,1991,26.1,26,14,19,4,3,13,26,50.0,13,32,18,14,25,51,66,1,Matches
428,Fernando Calero,ESP,"DF,MF",Espanyol,La Liga,26,1995,17.9,46,29,27,15,4,21,34,61.8,13,31,13,18,13,59,52,0,Matches
429,Duje Ćaleta-Car,CRO,DF,Southampton,Premier League,25,1996,10.5,14,10,9,4,1,6,9,66.7,3,15,11,4,15,29,65,1,Matches
430,Duje Ćaleta-Car,CRO,DF,Marseille,Ligue 1,25,1996,0.1,0,0,0,0,0,0,0,0.0,0,0,0,0,0,0,1,0,Matches
431,Hakan Çalhanoğlu,TUR,MF,Inter,Serie A,28,1994,26.3,48,27,17,26,5,16,43,37.2,27,30,5,25,25,73,13,1,Matches
432,Kerim Calhanoglu,GER,DF,Schalke 04,Bundesliga,19,2002,0.7,2,1,2,0,0,2,2,100.0,0,1,0,1,0,2,3,0,Matches
433,Daniel Caligiuri,ITA,"DF,MF",Augsburg,Bundesliga,34,1988,3.2,8,5,5,3,0,4,5,80.0,1,3,2,1,3,11,2,0,Matches
434,Alexander Callens,PER,DF,Girona,La Liga,30,1992,1.3,3,3,2,1,0,3,4,75.0,1,3,1,2,1,4,9,0,Matches
435,Dominic Calvert-Lewin,ENG,FW,Everton,Premier League,25,1997,12.9,4,2,1,0,3,1,5,20.0,4,5,1,4,3,7,18,0,Matches
436,Mahdi Camara,FRA,MF,Brest,Ligue 1,24,1998,20.2,63,36,18,38,7,25,43,58.1,18,35,4,31,40,103,16,0,Matches
437,Mohamed Camara,GUI,MF,Roma,Serie A,25,1997,7.7,13,10,3,7,3,5,15,33.3,10,5,1,4,10,23,8,0,Matches
438,Mohamed Camara,MLI,MF,Monaco,Ligue 1,22,2000,24.4,83,45,38,39,6,48,92,52.2,44,45,6,39,27,110,14,1,Matches
439,Ousmane Camara,GUI,"FW,MF",Auxerre,Ligue 1,20,2001,0.3,1,1,0,0,1,0,0,0.0,0,0,0,0,0,1,0,0,Matches
440,Ousmane Camara,FRA,DF,Angers,Ligue 1,19,2003,5.8,10,6,5,5,0,5,12,41.7,7,4,2,2,11,21,15,0,Matches
441,Eduardo Camavinga,FRA,"MF,DF",Real Madrid,La Liga,19,2002,22.3,68,48,32,21,15,24,64,37.5,40,24,5,19,17,85,25,0,Matches
442,Nicolò Cambiaghi,ITA,"FW,MF",Empoli,Serie A,21,2000,14.3,30,22,11,12,7,8,27,29.6,19,19,1,18,9,39,8,0,Matches
443,Andrea Cambiaso,ITA,DF,Bologna,Serie A,22,2000,24.1,57,34,34,20,3,28,65,43.1,37,26,2,24,26,83,33,1,Matches
444,Axel Camblan,FRA,"FW,MF",Brest,Ligue 1,18,2003,0.8,2,2,1,1,0,0,1,0.0,1,0,0,0,0,2,0,0,Matches
445,Sergio Camello,ESP,FW,Rayo Vallecano,La Liga,21,2001,26.7,16,10,3,9,4,5,17,29.4,12,9,1,8,2,18,26,0,Matches
446,Chem Campbell,WAL,"FW,MF",Wolves,Premier League,19,2002,0.8,2,1,1,1,0,0,1,0.0,1,2,0,2,1,3,0,0,Matches
447,Emre Can,GER,MF,Dortmund,Bundesliga,28,1994,21.1,57,28,25,27,5,22,43,51.2,21,16,6,10,25,82,39,1,Matches
448,Sergio Canales,ESP,"FW,MF",Betis,La Liga,31,1991,26.7,25,14,10,8,7,14,33,42.4,19,18,0,18,14,39,8,0,Matches
449,Matteo Cancellieri,ITA,FW,Lazio,Serie A,20,2002,2.8,10,4,5,3,2,5,9,55.6,4,4,0,4,1,11,2,0,Matches
450,João Cancelo,POR,DF,Manchester City,Premier League,28,1994,14.2,29,21,16,9,4,17,24,70.8,7,7,1,6,19,48,9,1,Matches
451,João Cancelo,POR,"DF,FW",Bayern Munich,Bundesliga,28,1994,11.2,23,14,9,10,4,10,23,43.5,13,14,2,12,15,38,22,0,Matches
452,Antonio Candreva,ITA,"MF,DF",Salernitana,Serie A,35,1987,30.3,17,7,13,2,2,11,38,28.9,27,7,3,4,17,34,32,0,Matches
453,Thomas Cannon,IRL,FW,Everton,Premier League,19,2002,0.3,0,0,0,0,0,0,0,0.0,0,0,0,0,0,0,0,0,Matches
454,Sergi Canós,ESP,"FW,DF",Brentford,Premier League,25,1997,0.9,0,0,0,0,0,0,2,0.0,2,3,1,2,0,0,1,0,Matches
455,Ander Capa,ESP,DF,Athletic Club,La Liga,30,1992,1.2,1,1,1,0,0,1,5,20.0,4,5,0,5,0,1,2,0,Matches
456,Pierrick Capelle,FRA,"MF,DF",Angers,Ligue 1,35,1987,15.9,36,21,17,15,4,22,55,40.0,33,24,3,21,15,51,24,0,Matches
457,Étienne Capoue,FRA,MF,Villarreal,La Liga,34,1988,21.7,21,12,6,13,2,10,18,55.6,8,12,5,7,19,40,20,1,Matches
458,Gianluca Caprari,ITA,"MF,FW",Monza,Serie A,29,1993,27.1,16,6,3,11,2,8,26,30.8,18,22,1,21,8,24,3,0,Matches
459,Francesco Caputo,ITA,FW,Sampdoria,Serie A,34,1987,12.2,3,1,0,0,3,0,3,0.0,3,0,0,0,1,4,3,0,Matches
460,Francesco Caputo,ITA,FW,Empoli,Serie A,34,1987,19.0,2,2,0,1,1,0,1,0.0,1,7,2,5,2,4,8,0,Matches
461,Maxence Caqueret,FRA,MF,Lyon,Ligue 1,22,2000,30.7,87,54,27,38,22,43,109,39.4,66,45,3,42,39,126,27,0,Matches
462,Andrea Carboni,ITA,DF,Monza,Serie A,21,2001,1.9,3,2,2,0,1,2,5,40.0,3,3,2,1,3,6,2,1,Matches
463,Franco Carboni,ITA,"DF,FW",Monza,Serie A,19,2003,0.7,1,1,1,0,0,0,2,0.0,2,3,0,3,1,2,0,0,Matches
464,Valentin Carboni,ARG,"MF,DF",Inter,Serie A,17,2005,0.3,1,1,0,1,0,1,3,33.3,2,1,0,1,0,1,0,0,Matches
465,Isaac Carcelen,ESP,DF,Cádiz,La Liga,29,1993,24.4,69,51,41,22,6,41,63,65.1,22,35,11,24,19,88,80,1,Matches
466,Irvin Cardona,FRA,"FW,MF",Brest,Ligue 1,24,1997,2.6,2,0,1,1,0,0,3,0.0,3,3,0,3,2,4,2,0,Matches
467,Irvin Cardona,FRA,"MF,FW",Augsburg,Bundesliga,24,1997,3.5,1,1,1,0,0,1,5,20.0,4,3,0,3,4,5,8,0,Matches
468,Igor Carioca,BRA,DF,Lorient,Ligue 1,25,1996,5.1,18,11,12,2,4,12,21,57.1,9,7,0,7,5,23,17,0,Matches
469,Carlos,BRA,DF,Monza,Serie A,23,1999,34.3,73,38,42,23,8,33,54,61.1,21,24,6,18,24,97,85,1,Matches
470,Diego Carlos,BRA,DF,Aston Villa,Premier League,29,1993,2.3,1,0,0,1,0,0,1,0.0,1,2,2,0,1,2,2,0,Matches
471,Juan Carlos,ESP,GK,Girona,La Liga,34,1988,10.0,0,0,0,0,0,0,0,0.0,0,0,0,0,1,1,7,1,Matches
472,José Carlos Lazo,ESP,"MF,FW",Almería,La Liga,26,1996,0.2,0,0,0,0,0,0,0,0.0,0,0,0,0,0,0,0,0,Matches
473,José Carlos Lazo,ESP,"MF,FW",Espanyol,La Liga,26,1996,1.8,5,3,2,2,1,3,3,100.0,0,2,0,2,3,8,5,0,Matches
474,Carmona,ESP,"MF,DF",Elche,La Liga,20,2002,6.5,16,9,7,6,3,6,16,37.5,10,14,2,12,8,24,9,0,Matches
475,Carmona,ESP,DF,Sevilla,La Liga,20,2002,5.9,13,11,5,3,5,9,16,56.3,7,10,6,4,7,20,17,1,Matches
476,Marco Carnesecchi,ITA,GK,Cremonese,Serie A,22,2000,27.0,1,1,1,0,0,1,2,50.0,1,0,0,0,0,1,11,2,Matches
477,Yannick Carrasco,BEL,"DF,MF",Atlético Madrid,La Liga,28,1993,25.7,35,14,21,10,4,23,54,42.6,31,23,1,22,12,47,19,0,Matches
478,Dani Carvajal,ESP,DF,Real Madrid,La Liga,30,1992,19.8,32,18,15,12,5,18,35,51.4,17,24,6,18,15,47,49,0,Matches
479,Fabio Carvalho,POR,"MF,FW",Liverpool,Premier League,19,2002,3.9,8,8,3,3,2,3,6,50.0,3,6,0,6,6,14,0,0,Matches
480,Matis Carvalho,POR,GK,Montpellier,Ligue 1,23,1999,1.5,0,0,0,0,0,0,0,0.0,0,0,0,0,1,1,0,0,Matches
481,William Carvalho,POR,MF,Betis,La Liga,30,1992,27.1,43,27,18,23,2,17,44,38.6,27,27,6,21,16,59,22,0,Matches
482,Nicolò Casale,ITA,DF,Lazio,Serie A,24,1998,27.1,42,20,28,14,0,22,34,64.7,12,25,17,8,17,59,73,1,Matches
483,Casemiro,BRA,MF,Manchester Utd,Premier League,30,1992,23.6,89,46,43,35,11,48,92,52.2,44,49,11,38,34,123,64,0,Matches
484,Casemiro,BRA,MF,Real Madrid,La Liga,30,1992,0.1,0,0,0,0,0,0,0,0.0,0,0,0,0,0,0,1,0,Matches
485,Matty Cash,POL,DF,Aston Villa,Premier League,24,1997,20.2,55,32,36,15,4,26,37,70.3,11,20,5,15,26,81,43,0,Matches
486,Tommaso Cassandro,ITA,DF,Lecce,Serie A,22,2000,0.1,1,1,0,1,0,0,0,0.0,0,1,1,0,0,1,0,0,Matches
487,Timothy Castagne,BEL,DF,Leicester City,Premier League,26,1995,36.2,87,44,53,27,7,41,84,48.8,43,50,13,37,43,130,110,0,Matches
488,Michele Castagnetti,ITA,MF,Cremonese,Serie A,32,1989,15.7,46,21,20,24,2,18,54,33.3,36,14,4,10,15,61,22,0,Matches
489,Koen Casteels,BEL,GK,Wolfsburg,Bundesliga,30,1992,34.0,0,0,0,0,0,0,0,0.0,0,0,0,0,1,1,10,1,Matches
490,Valentín Castellanos,ARG,FW,Girona,La Liga,23,1998,28.9,12,5,2,7,3,0,18,0.0,18,22,2,20,6,18,26,0,Matches
491,Jean-Charles Castelletto,CMR,DF,Nantes,Ligue 1,27,1995,28.5,43,26,29,12,2,22,36,61.1,14,35,22,13,58,101,90,0,Matches
492,Samu Castillejo,ESP,"FW,MF",Valencia,La Liga,27,1995,15.1,21,12,8,9,4,8,40,20.0,32,21,2,19,9,30,2,0,Matches
493,Jonny Castro,ESP,DF,Wolves,Premier League,28,1994,14.0,34,15,23,10,1,18,37,48.6,19,26,5,21,14,48,28,2,Matches
494,Gaetano Castrovilli,ITA,MF,Fiorentina,Serie A,25,1997,8.0,10,8,1,7,2,2,9,22.2,7,5,1,4,8,18,5,0,Matches
495,Danilo Cataldi,ITA,MF,Lazio,Serie A,27,1994,21.3,25,16,7,15,3,14,40,35.0,26,23,9,14,24,49,33,0,Matches
496,Catena,ESP,DF,Rayo Vallecano,La Liga,27,1994,34.5,29,14,23,4,2,13,27,48.1,14,32,25,7,28,57,159,1,Matches
497,Yoann Cathline,FRA,"FW,MF",Lorient,Ligue 1,20,2002,12.1,19,12,7,6,6,5,12,41.7,7,10,1,9,8,27,16,1,Matches
498,Maximiliano Caufriez,BEL,DF,Clermont Foot,Ligue 1,25,1997,24.7,40,24,31,8,1,20,28,71.4,8,33,18,15,34,74,70,0,Matches
499,Edinson Cavani,URU,FW,Valencia,La Liga,35,1987,16.1,7,4,3,3,1,3,15,20.0,12,10,3,7,2,9,11,0,Matches
500,Dani Ceballos,ESP,MF,Real Madrid,La Liga,25,1996,17.4,43,29,13,15,15,25,64,39.1,39,23,2,21,25,68,6,1,Matches
501,Pietro Ceccaroni,ITA,DF,Lecce,Serie A,26,1995,0.5,0,0,0,0,0,0,0,0.0,0,1,1,0,3,3,2,0,Matches
502,Federico Ceccherini,ITA,DF,Hellas Verona,Serie A,30,1992,15.7,25,19,15,9,1,13,23,56.5,10,17,10,7,19,44,55,0,Matches
503,Assan Ceesay,GAM,FW,Lecce,Serie A,28,1994,20.1,23,18,7,8,8,9,17,52.9,8,15,2,13,3,26,24,0,Matches
504,Emil Ceide,NOR,FW,Sassuolo,Serie A,20,2001,5.7,5,2,5,0,0,3,5,60.0,2,3,1,2,1,6,0,0,Matches
505,Zeki Çelik,TUR,DF,Roma,Serie A,25,1997,16.7,42,21,19,21,2,24,41,58.5,17,33,6,27,14,56,36,2,Matches
506,Álex Centelles,ESP,DF,Almería,La Liga,24,1997,12.5,22,14,16,3,3,16,22,72.7,6,13,2,11,11,33,40,0,Matches
507,Fabien Centonze,FRA,DF,Nantes,Ligue 1,26,1996,18.8,58,37,30,22,6,30,42,71.4,12,24,7,17,44,102,55,1,Matches
508,Michele Cerofolini,ITA,GK,Fiorentina,Serie A,23,1999,5.0,0,0,0,0,0,0,0,0.0,0,0,0,0,1,1,2,0,Matches
509,Franco Cervi,ARG,"MF,DF",Celta Vigo,La Liga,28,1994,21.0,76,46,29,36,11,33,66,50.0,33,33,1,32,36,112,16,0,Matches
510,Julio César Enciso,PAR,"FW,MF",Brighton,Premier League,18,2004,9.0,13,4,3,6,4,8,13,61.5,5,9,0,9,4,17,2,0,Matches
511,Julian Chabot,GER,DF,Köln,Bundesliga,24,1998,20.0,36,23,19,14,3,20,35,57.1,15,30,18,12,41,77,105,0,Matches
512,Florian Chabrolle,FRA,MF,Ajaccio,Ligue 1,24,1998,3.7,6,4,1,5,0,2,4,50.0,2,3,0,3,7,13,2,0,Matches
513,El Chadaille Bitshiabu,FRA,DF,Paris S-G,Ligue 1,17,2005,6.5,10,7,7,2,1,3,12,25.0,9,9,7,2,9,19,13,3,Matches
514,Fares Chaïbi,ALG,"FW,MF",Toulouse,Ligue 1,19,2002,26.0,31,18,8,15,8,17,50,34.0,33,38,5,33,19,50,36,1,Matches
515,Nathaniel Chalobah,ENG,MF,Fulham,Premier League,27,1994,0.1,1,1,1,0,0,1,1,100.0,0,0,0,0,0,1,2,0,Matches
516,Trevoh Chalobah,ENG,DF,Chelsea,Premier League,23,1999,17.9,31,20,22,6,3,24,34,70.6,10,17,7,10,24,55,56,1,Matches
517,Muhammed Cham,AUT,MF,Clermont Foot,Ligue 1,21,2000,21.9,30,15,15,4,11,13,35,37.1,22,13,0,13,7,37,5,0,Matches
518,Calum Chambers,ENG,"DF,MF",Aston Villa,Premier League,27,1995,3.9,9,6,7,2,0,6,8,75.0,2,5,4,1,7,16,10,1,Matches
519,Timothy Chandler,USA,DF,Eint Frankfurt,Bundesliga,32,1990,1.0,2,2,2,0,0,2,2,100.0,0,1,0,1,0,2,3,0,Matches
520,Gaëtan Charbonnier,FRA,"FW,MF",Auxerre,Ligue 1,33,1988,2.8,2,1,0,2,0,0,4,0.0,4,2,0,2,0,2,5,0,Matches
521,Brendan Chardonnet,FRA,DF,Brest,Ligue 1,27,1994,27.7,45,27,27,18,0,20,38,52.6,18,40,19,21,63,108,86,1,Matches
522,Shea Charles,NIR,DF,Manchester City,Premier League,18,2003,0.3,4,0,4,0,0,1,1,100.0,0,0,0,0,1,5,2,0,Matches
523,Xavier Chavalerin,FRA,MF,Troyes,Ligue 1,31,1991,27.0,82,50,39,30,13,27,71,38.0,44,31,8,23,41,123,24,0,Matches
524,Pep Chavarría,ESP,"FW,MF",Rayo Vallecano,La Liga,24,1998,4.1,6,4,2,1,3,1,5,20.0,4,8,0,8,2,8,8,0,Matches
525,Ivane Chegra,FRA,"MF,FW",Ajaccio,Ligue 1,18,2004,2.1,8,3,6,1,1,4,11,36.4,7,0,0,0,1,9,0,0,Matches
526,Pape Cheikh Diop,SEN,MF,Elche,La Liga,24,1997,0.4,0,0,0,0,0,0,1,0.0,1,0,0,0,0,0,0,0,Matches
527,Rayan Cherki,FRA,"MF,FW",Lyon,Ligue 1,18,2003,20.8,14,8,2,5,7,8,23,34.8,15,6,0,6,5,19,1,0,Matches
528,Ilyes Cheti,ALG,DF,Angers,Ligue 1,27,1995,2.3,6,4,4,0,2,5,8,62.5,3,5,1,4,4,10,7,0,Matches
529,Lucas Chevalier,FRA,GK,Lille,Ligue 1,20,2001,32.0,2,1,2,0,0,2,2,100.0,0,1,0,1,2,4,7,2,Matches
530,Fabio Chiarodia,ITA,DF,Werder Bremen,Bundesliga,17,2005,0.7,0,0,0,0,0,0,0,0.0,0,1,0,1,2,2,4,0,Matches
531,Federico Chiesa,ITA,"DF,MF",Juventus,Serie A,24,1997,9.5,22,11,6,6,10,5,14,35.7,9,13,1,12,0,22,1,0,Matches
532,Ben Chilwell,ENG,"DF,MF",Chelsea,Premier League,25,1996,15.6,21,17,12,8,1,13,25,52.0,12,21,2,19,18,39,26,0,Matches
533,Vlad Chiricheș,ROU,DF,Cremonese,Serie A,32,1989,10.9,35,20,27,7,1,16,24,66.7,8,36,23,13,22,57,44,0,Matches
534,Pedro Chirivella,ESP,MF,Nantes,Ligue 1,25,1997,22.5,33,22,12,15,6,17,44,38.6,27,24,1,23,20,53,7,0,Matches
535,Joris Chotard,FRA,MF,Montpellier,Ligue 1,20,2001,27.3,64,34,37,23,4,40,78,51.3,38,40,11,29,40,104,42,1,Matches
536,Andreas Christensen,DEN,DF,Barcelona,La Liga,26,1996,19.6,20,15,9,11,0,10,16,62.5,6,14,12,2,21,41,47,0,Matches
537,Oliver Christensen,DEN,GK,Hertha BSC,Bundesliga,23,1999,33.0,1,0,1,0,0,0,2,0.0,2,0,0,0,0,1,22,2,Matches
538,Ryan Christie,SCO,"MF,FW",Bournemouth,Premier League,27,1995,20.4,34,22,10,23,1,14,49,28.6,35,16,4,12,26,60,20,0,Matches
539,Carney Chukwuemeka,ENG,"MF,FW",Chelsea,Premier League,18,2003,3.9,13,7,7,6,0,3,5,60.0,2,7,0,7,6,19,1,0,Matches
540,Samuel Chukwueze,NGA,"FW,MF",Villarreal,La Liga,23,1999,26.0,14,7,7,2,5,7,23,30.4,16,13,0,13,12,26,16,0,Matches
541,Darko Churlinov,MKD,FW,Stuttgart,Bundesliga,22,2000,0.3,3,2,2,1,0,2,3,66.7,1,1,0,1,0,3,0,0,Matches
542,Víctor Chust,ESP,DF,Cádiz,La Liga,22,2000,10.7,9,6,7,2,0,4,7,57.1,3,8,3,5,10,19,53,0,Matches
543,Tolga Ciğerci,TUR,MF,Hertha BSC,Bundesliga,30,1992,7.5,16,13,6,9,1,10,16,62.5,6,6,2,4,8,24,5,0,Matches
544,Yanis Cimignani,FRA,"MF,DF",Ajaccio,Ligue 1,20,2002,3.1,11,5,3,7,1,4,5,80.0,1,5,1,4,2,13,2,0,Matches
545,Daniel Ciofani,ITA,FW,Cremonese,Serie A,37,1985,11.8,6,3,1,2,3,4,7,57.1,3,7,1,6,2,8,10,0,Matches
546,Tio Cipot,SVN,"FW,MF",Spezia,Serie A,19,2003,1.5,12,7,6,3,3,6,8,75.0,2,0,0,0,0,12,2,0,Matches
547,Pathé Ciss,SEN,"MF,DF",Rayo Vallecano,La Liga,28,1994,14.2,39,29,11,23,5,15,34,44.1,19,23,10,13,22,61,34,0,Matches
548,Souleymane Cissé,FRA,DF,Clermont Foot,Ligue 1,19,2002,0.4,1,1,1,0,0,1,1,100.0,0,1,1,0,1,2,2,0,Matches
549,Patrick Ciurria,ITA,"DF,MF",Monza,Serie A,27,1995,30.6,31,18,20,10,1,17,33,51.5,16,24,2,22,7,38,32,0,Matches
550,Bobby Clark,ENG,MF,Liverpool,Premier League,17,2005,0.1,0,0,0,0,0,0,0,0.0,0,2,0,2,0,0,0,0,Matches
551,Alexis Claude-Maurice,FRA,FW,Nice,Ligue 1,24,1998,0.7,3,2,2,1,0,3,3,100.0,0,0,0,0,2,5,1,0,Matches
552,Alexis Claude-Maurice,FRA,"MF,FW",Lens,Ligue 1,24,1998,6.7,14,9,5,8,1,6,16,37.5,10,6,0,6,2,16,1,0,Matches
553,Jonathan Clauss,FRA,DF,Marseille,Ligue 1,29,1992,28.8,46,28,21,16,9,23,52,44.2,29,29,4,25,31,77,40,2,Matches
554,Carlos Clerc,ESP,"DF,MF",Elche,La Liga,30,1992,29.3,75,51,55,16,4,31,50,62.0,19,29,7,22,28,103,94,1,Matches
555,Nathaniel Clyne,ENG,DF,Crystal Palace,Premier League,31,1991,18.2,27,16,13,9,5,14,23,60.9,9,22,4,18,19,46,34,0,Matches
556,Conor Coady,ENG,DF,Everton,Premier League,29,1993,23.3,14,9,8,6,0,7,15,46.7,8,21,17,4,14,28,88,3,Matches
557,Nicolò Cocetta,ITA,DF,Udinese,Serie A,18,2003,0.4,0,0,0,0,0,0,1,0.0,1,1,1,0,1,1,1,0,Matches
558,Marcus Coco,FRA,"FW,MF",Nantes,Ligue 1,26,1996,7.1,24,15,11,9,4,11,23,47.8,12,13,3,10,14,38,7,0,Matches
559,Alexandre Coeff,FRA,DF,Auxerre,Ligue 1,30,1992,6.5,10,5,6,4,0,4,9,44.4,5,9,4,5,8,18,35,1,Matches
560,Jack Colback,ENG,MF,Nott'ham Forest,Premier League,32,1989,5.5,18,13,12,6,0,5,8,62.5,3,3,0,3,3,21,9,0,Matches
561,Séamus Coleman,IRL,DF,Everton,Premier League,33,1988,18.4,35,26,21,10,4,19,29,65.5,10,14,7,7,22,57,58,2,Matches
562,David Čolina,CRO,"DF,FW",Augsburg,Bundesliga,22,2000,1.8,4,1,1,1,2,2,2,100.0,0,8,0,8,4,8,3,0,Matches
563,Álex Collado,ESP,MF,Elche,La Liga,23,1999,8.1,26,14,13,11,2,8,13,61.5,5,12,1,11,2,28,4,0,Matches
564,Diego Collado,ESP,FW,Villarreal,La Liga,21,2001,0.1,0,0,0,0,0,0,0,0.0,0,0,0,0,0,0,0,0,Matches
565,Omar Colley,GAM,DF,Sampdoria,Serie A,29,1992,15.4,17,10,10,7,0,9,12,75.0,3,9,5,4,22,39,69,1,Matches
566,Nathan Collins,IRL,DF,Wolves,Premier League,21,2001,20.2,27,15,19,8,0,15,24,62.5,9,35,28,7,21,48,84,0,Matches
567,Lorenzo Colombo,ITA,FW,Lecce,Serie A,20,2002,16.8,17,9,1,9,7,6,14,42.9,8,22,0,22,2,19,7,0,Matches
568,Andrea Colpani,ITA,MF,Monza,Serie A,23,1999,10.5,14,9,6,5,3,8,12,66.7,4,14,2,12,3,17,6,0,Matches
569,Levi Colwill,ENG,DF,Brighton,Premier League,19,2003,13.6,8,7,4,4,0,4,9,44.4,5,5,3,2,15,23,37,1,Matches
570,Kingsley Coman,FRA,"FW,MF",Bayern Munich,Bundesliga,26,1996,15.7,11,8,3,5,3,7,17,41.2,10,19,1,18,2,13,7,0,Matches
571,Eray Cömert,SUI,DF,Valencia,La Liga,24,1998,18.6,35,23,24,10,1,17,33,51.5,16,23,8,15,29,64,76,1,Matches
572,Santi Comesaña,ESP,MF,Rayo Vallecano,La Liga,25,1996,27.2,71,44,24,41,6,38,82,46.3,44,39,3,36,32,103,17,0,Matches
573,Andrea Consigli,ITA,GK,Sassuolo,Serie A,35,1987,35.0,1,0,1,0,0,0,1,0.0,1,0,0,0,0,1,13,3,Matches
574,Abdu Conté,POR,DF,Troyes,Ligue 1,24,1998,14.6,25,17,14,8,3,12,22,54.5,10,13,6,7,6,31,25,0,Matches
575,Andrea Conti,ITA,DF,Sampdoria,Serie A,28,1994,0.3,0,0,0,0,0,0,0,0.0,0,0,0,0,0,0,0,0,Matches
576,Lewis Cook,ENG,MF,Bournemouth,Premier League,25,1997,19.1,37,22,10,22,5,18,42,42.9,24,29,10,19,23,60,31,0,Matches
577,Steve Cook,ENG,DF,Nott'ham Forest,Premier League,31,1991,10.6,8,4,4,4,0,5,7,71.4,2,16,11,5,12,20,51,0,Matches
578,Liam Cooper,SCO,DF,Leeds United,Premier League,30,1991,15.8,38,23,27,9,2,23,36,63.9,13,16,8,8,34,72,57,3,Matches
579,Copete,ESP,DF,Mallorca,La Liga,22,1999,24.5,53,28,35,16,2,26,36,72.2,10,38,17,21,44,97,111,2,Matches
580,Diego Coppola,ITA,DF,Hellas Verona,Serie A,18,2003,13.1,25,17,15,10,0,11,24,45.8,13,20,6,14,14,39,38,0,Matches
581,Francis Coquelin,FRA,MF,Villarreal,La Liga,31,1991,8.3,18,13,7,9,2,7,7,100.0,0,8,2,6,9,27,7,0,Matches
582,Sébastien Corchia,FRA,DF,Nantes,Ligue 1,31,1990,8.7,16,6,10,2,4,11,22,50.0,11,9,3,6,14,30,21,0,Matches
583,Alex Cordaz,ITA,GK,Inter,Serie A,39,1983,0.3,0,0,0,0,0,0,0,0.0,0,0,0,0,0,0,0,0,Matches
584,Maxwel Cornet,CIV,FW,West Ham,Premier League,25,1996,2.7,7,3,5,0,2,4,6,66.7,2,6,0,6,2,9,3,0,Matches
585,Jesús Corona,MEX,FW,Sevilla,La Liga,29,1993,1.2,1,0,1,0,0,0,1,0.0,1,0,0,0,1,2,1,0,Matches
586,Ángel Correa,ARG,"FW,MF",Atlético Madrid,La Liga,27,1995,16.2,12,6,6,3,3,5,16,31.3,11,17,0,17,10,22,6,1,Matches
587,Joaquín Correa,ARG,FW,Inter,Serie A,27,1994,10.6,12,7,3,6,3,4,15,26.7,11,4,1,3,3,15,0,0,Matches
588,Thierry Correia,POR,DF,Valencia,La Liga,23,1999,22.3,71,52,46,22,3,31,54,57.4,23,25,2,23,24,95,54,2,Matches
589,Alessandro Cortinovis,ITA,MF,Hellas Verona,Serie A,21,2001,0.1,1,0,1,0,0,0,0,0.0,0,1,0,1,0,1,0,0,Matches
590,Danny da Costa,GER,DF,Mainz 05,Bundesliga,29,1993,13.7,20,16,7,8,5,12,20,60.0,8,22,3,19,9,29,26,0,Matches
591,David Pereira da Costa,POR,"MF,FW",Lens,Ligue 1,21,2001,15.6,13,7,1,10,2,7,19,36.8,12,19,1,18,11,24,6,0,Matches
592,Diego Costa,ESP,FW,Wolves,Premier League,33,1988,13.8,3,1,3,0,0,2,9,22.2,7,6,1,5,2,5,17,0,Matches
593,Jaume Costa,ESP,DF,Mallorca,La Liga,34,1988,28.9,50,34,26,17,7,29,51,56.9,22,13,5,8,22,72,44,1,Matches
594,Logan Costa,CPV,DF,Toulouse,Ligue 1,21,2001,4.6,9,4,7,1,1,6,9,66.7,3,6,3,3,4,13,12,0,Matches
595,Nuno da Costa,CPV,"FW,MF",Auxerre,Ligue 1,31,1991,22.3,45,23,14,23,8,11,46,23.9,35,21,1,20,20,65,15,0,Matches
596,Samu Costa,POR,MF,Almería,La Liga,21,2000,22.1,61,31,35,20,6,29,61,47.5,32,29,7,22,37,98,64,4,Matches
597,Benoît Costil,FRA,GK,Auxerre,Ligue 1,35,1987,19.0,2,0,2,0,0,2,4,50.0,2,0,0,0,0,2,5,0,Matches
598,Vladimír Coufal,CZE,DF,West Ham,Premier League,29,1992,23.7,58,31,37,15,6,36,51,70.6,15,24,6,18,38,96,70,0,Matches
599,Lassana Coulibaly,MLI,MF,Salernitana,Serie A,26,1996,32.1,84,50,42,35,7,30,73,41.1,43,35,7,28,25,109,33,2,Matches
600,Soumaïla Coulibaly,FRA,DF,Dortmund,Bundesliga,18,2003,0.5,0,0,0,0,0,0,0,0.0,0,0,0,0,0,0,0,1,Matches
601,Tanguy Coulibaly,FRA,"FW,DF",Stuttgart,Bundesliga,21,2001,3.6,12,9,9,1,2,5,12,41.7,7,10,0,10,3,15,0,0,Matches
602,Thibaut Courtois,BEL,GK,Real Madrid,La Liga,30,1992,31.0,1,0,1,0,0,1,1,100.0,0,0,0,0,3,4,7,1,Matches
603,Mathieu Coutadeur,FRA,MF,Ajaccio,Ligue 1,36,1986,21.6,23,13,13,10,0,8,28,28.6,20,19,3,16,19,42,21,0,Matches
604,Philippe Coutinho,BRA,"MF,FW",Aston Villa,Premier League,30,1992,8.8,19,14,8,8,3,9,15,60.0,6,11,1,10,4,23,2,0,Matches
605,Yan Couto,BRA,"DF,MF",Girona,La Liga,20,2002,12.9,25,18,11,11,3,12,20,60.0,8,7,2,5,5,30,10,0,Matches
606,Conor Coventry,IRL,"MF,FW",West Ham,Premier League,22,2000,0.0,0,0,0,0,0,0,0,0.0,0,0,0,0,0,0,0,0,Matches
607,Nicolas Cozza,FRA,DF,Montpellier,Ligue 1,23,1999,14.2,38,21,27,9,2,26,38,68.4,12,11,5,6,21,59,35,1,Matches
608,Nicolas Cozza,FRA,DF,Wolfsburg,Bundesliga,23,1999,1.1,3,3,1,2,0,2,3,66.7,1,3,1,2,0,3,0,0,Matches
609,Alessio Cragno,ITA,GK,Monza,Serie A,28,1994,1.0,0,0,0,0,0,0,1,0.0,1,0,0,0,0,0,0,0,Matches
610,Matthew Craig,SCO,MF,Tottenham,Premier League,19,2003,0.2,4,1,2,2,0,0,0,0.0,0,0,0,0,0,4,0,0,Matches
611,Aaron Cresswell,ENG,DF,West Ham,Premier League,32,1989,24.8,21,11,12,7,2,12,31,38.7,19,21,11,10,27,48,56,0,Matches
612,Bryan Cristante,ITA,"MF,DF",Roma,Serie A,27,1995,32.6,113,62,55,49,9,55,90,61.1,35,39,10,29,18,131,53,0,Matches
613,Domen Črnigoj,SVN,MF,Salernitana,Serie A,26,1995,3.3,8,3,0,7,1,1,2,50.0,1,9,1,8,9,17,6,0,Matches
614,Juan Cruz Armada,ESP,DF,Osasuna,La Liga,30,1992,22.9,24,14,17,4,3,13,23,56.5,10,21,8,13,13,37,58,0,Matches
615,Juan Cruz,ESP,FW,Betis,La Liga,22,2000,2.0,1,0,0,1,0,1,3,33.3,2,1,0,1,0,1,0,0,Matches
616,Juan Cuadrado,COL,"DF,FW",Juventus,Serie A,34,1988,23.1,50,34,34,13,3,27,65,41.5,38,15,2,13,24,74,32,0,Matches
617,Marc Cucurella,ESP,DF,Chelsea,Premier League,24,1998,18.6,66,33,40,15,11,30,60,50.0,30,28,8,20,16,82,48,1,Matches
618,Jorge Cuenca,ESP,DF,Villarreal,La Liga,22,1999,5.6,9,7,7,2,0,4,7,57.1,3,10,8,2,6,15,44,0,Matches
619,Braian Cufré,ARG,DF,Mallorca,La Liga,25,1996,2.4,5,2,2,1,2,2,5,40.0,3,2,1,1,2,7,1,0,Matches
620,Mickaël Cuisance,FRA,MF,Sampdoria,Serie A,22,1999,6.9,13,10,7,5,1,5,23,21.7,18,10,0,10,5,18,4,0,Matches
621,Matheus Cunha,BRA,FW,Wolves,Premier League,23,1999,10.7,7,4,0,5,2,2,10,20.0,8,15,3,12,9,16,11,0,Matches
622,Matheus Cunha,BRA,"FW,MF",Atlético Madrid,La Liga,23,1999,4.2,4,1,1,3,0,0,3,0.0,3,4,1,3,2,6,3,0,Matches
623,Curro,ESP,MF,Almería,La Liga,26,1996,0.5,2,0,1,1,0,1,2,50.0,1,0,0,0,0,2,0,0,Matches
624,Marco D'Alessandro,ITA,"DF,FW",Monza,Serie A,31,1991,3.2,4,4,3,1,0,2,5,40.0,3,2,0,2,1,5,3,0,Matches
625,Danilo D'Ambrosio,ITA,DF,Inter,Serie A,33,1988,8.1,25,17,17,7,1,15,27,55.6,12,12,4,8,10,35,17,0,Matches
626,Luca D'Andrea,ITA,FW,Sassuolo,Serie A,17,2004,3.5,4,0,2,1,1,1,4,25.0,3,2,0,2,1,5,1,0,Matches
627,Damien Da Silva,FRA,DF,Lyon,Ligue 1,34,1988,3.8,8,7,5,3,0,3,3,100.0,0,4,3,1,5,13,12,0,Matches
628,Moanes Dabbur,ISR,FW,Hoffenheim,Bundesliga,30,1992,10.4,11,8,4,5,2,3,9,33.3,6,8,0,8,5,16,0,0,Matches
629,Andréa Dacourt,FRA,MF,Nice,Ligue 1,17,2005,0.0,0,0,0,0,0,0,0,0.0,0,0,0,0,0,0,0,0,Matches
630,Colin Dagba,FRA,"DF,MF",Strasbourg,Ligue 1,23,1998,10.6,32,20,17,10,5,19,26,73.1,7,18,2,16,17,49,19,0,Matches
631,Finn Dahmen,GER,GK,Mainz 05,Bundesliga,24,1998,8.0,0,0,0,0,0,0,0,0.0,0,0,0,0,0,0,3,0,Matches
632,Mahmoud Dahoud,GER,MF,Dortmund,Bundesliga,26,1996,3.7,11,9,3,4,4,7,7,100.0,0,6,2,4,7,18,3,0,Matches
633,Patson Daka,ZAM,FW,Leicester City,Premier League,23,1998,13.2,14,8,6,8,0,3,12,25.0,9,14,2,12,7,21,7,0,Matches
634,Thijs Dallinga,NED,FW,Toulouse,Ligue 1,21,2000,26.1,8,6,2,2,4,1,13,7.7,12,17,3,14,3,11,20,0,Matches
635,Diogo Dalot,POR,DF,Manchester Utd,Premier League,23,1999,23.9,54,41,40,13,1,33,45,73.3,12,25,7,18,37,91,55,2,Matches
636,Muhammed Damar,GER,MF,Hoffenheim,Bundesliga,18,2004,1.8,6,3,1,2,3,1,2,50.0,1,3,0,3,0,6,0,0,Matches
637,Mikkel Damsgaard,DEN,"MF,FW",Brentford,Premier League,22,2000,11.0,31,21,13,13,5,15,42,35.7,27,20,2,18,10,41,14,0,Matches
638,Flavius Daniliuc,AUT,DF,Salernitana,Serie A,21,2001,24.4,57,29,37,17,3,26,47,55.3,21,30,13,17,29,86,76,0,Matches
639,Flavius Daniliuc,AUT,DF,Nice,Ligue 1,21,2001,1.0,2,0,2,0,0,1,1,100.0,0,4,1,3,0,2,1,0,Matches
640,Danilo,BRA,MF,Nott'ham Forest,Premier League,21,2001,10.8,18,7,7,9,2,6,25,24.0,19,26,6,20,9,27,19,0,Matches
641,Danilo,BRA,DF,Juventus,Serie A,31,1991,35.4,92,62,61,23,8,52,73,71.2,21,39,20,19,47,139,114,1,Matches
642,Arnaut Danjuma,NED,"FW,MF",Tottenham,Premier League,25,1997,1.9,2,0,1,1,0,0,0,0.0,0,1,0,1,0,2,0,0,Matches
643,Arnaut Danjuma,NED,FW,Villarreal,La Liga,25,1997,5.3,3,3,1,0,2,1,2,50.0,1,0,0,0,0,3,1,1,Matches
644,Kévin Danois,FRA,MF,Auxerre,Ligue 1,18,2004,0.0,1,1,0,1,0,0,0,0.0,0,0,0,0,1,2,0,0,Matches
645,Kevin Danso,AUT,DF,Lens,Ligue 1,23,1998,35.9,37,19,25,11,1,19,30,63.3,11,48,34,14,33,70,124,0,Matches
646,Dante,BRA,DF,Nice,Ligue 1,38,1983,36.7,70,40,45,21,4,36,59,61.0,23,52,31,21,47,117,125,2,Matches
647,Márton Dárdai,GER,"DF,MF",Hertha BSC,Bundesliga,20,2002,10.5,17,8,9,8,0,9,18,50.0,9,14,9,5,11,28,45,1,Matches
648,Sergi Darder,ESP,MF,Espanyol,La Liga,28,1993,36.9,69,38,12,43,14,29,73,39.7,44,34,2,32,24,93,23,0,Matches
649,Achraf Dari,MAR,DF,Brest,Ligue 1,23,1999,14.6,21,14,15,5,1,14,20,70.0,6,16,10,6,19,40,65,2,Matches
650,Vladimír Darida,CZE,MF,Hertha BSC,Bundesliga,31,1990,0.3,1,1,0,1,0,0,0,0.0,0,1,0,1,0,1,0,0,Matches
651,Matteo Darmian,ITA,DF,Inter,Serie A,32,1989,22.5,56,30,29,15,12,31,47,66.0,16,33,5,28,21,77,36,0,Matches
652,Josh Dasilva,ENG,MF,Brentford,Premier League,23,1998,15.4,18,9,6,6,6,6,16,37.5,10,22,6,16,5,23,7,1,Matches
653,David Datro Fofana,CIV,FW,Chelsea,Premier League,19,2002,0.8,3,1,1,1,1,1,1,100.0,0,1,0,1,0,3,0,0,Matches
654,Jonathan David,CAN,FW,Lille,Ligue 1,22,2000,35.2,24,17,6,11,7,10,27,37.0,17,20,2,18,8,32,13,0,Matches
655,Alphonso Davies,CAN,DF,Bayern Munich,Bundesliga,21,2000,22.7,45,28,25,13,7,18,39,46.2,21,28,4,24,24,69,24,4,Matches
656,Ben Davies,WAL,DF,Tottenham,Premier League,29,1993,25.4,28,11,13,13,2,14,26,53.8,12,17,8,9,18,46,72,0,Matches
657,Tom Davies,ENG,MF,Everton,Premier League,24,1998,6.0,15,9,5,9,1,7,14,50.0,7,10,1,9,4,19,7,1,Matches
658,Paweł Dawidowicz,POL,DF,Hellas Verona,Serie A,27,1995,18.1,48,31,28,17,3,22,31,71.0,9,14,9,5,23,71,71,0,Matches
659,Craig Dawson,ENG,DF,West Ham,Premier League,32,1990,8.0,10,6,8,2,0,4,6,66.7,2,9,6,3,6,16,26,0,Matches
660,Craig Dawson,ENG,DF,Wolves,Premier League,32,1990,15.7,9,6,6,3,0,4,7,57.1,3,31,23,8,12,21,74,2,Matches
661,Kevin De Bruyne,BEL,MF,Manchester City,Premier League,31,1991,26.9,28,12,3,12,13,14,39,35.9,25,27,2,25,9,37,10,0,Matches
662,Charles De Ketelaere,BEL,"MF,FW",Milan,Serie A,21,2001,12.4,26,12,7,14,5,13,30,43.3,17,14,2,12,4,30,9,0,Matches
663,Manuel De Luca,ITA,"FW,MF",Sampdoria,Serie A,24,1998,0.5,0,0,0,0,0,0,0,0.0,0,0,0,0,0,0,0,0,Matches
664,Tommaso De Nipoti,ITA,MF,Atalanta,Serie A,19,2003,0.0,1,0,0,1,0,0,0,0.0,0,0,0,0,0,1,0,0,Matches
665,Rodrigo De Paul,ARG,MF,Atlético Madrid,La Liga,28,1994,21.4,35,21,11,18,6,18,35,51.4,17,20,3,17,8,43,7,0,Matches
666,Mattia De Sciglio,ITA,DF,Juventus,Serie A,29,1992,11.6,14,7,8,3,3,9,14,64.3,5,9,3,6,4,18,20,0,Matches
667,Lorenzo De Silvestri,ITA,DF,Bologna,Serie A,34,1988,7.5,3,2,2,0,1,3,7,42.9,4,6,5,1,3,6,20,0,Matches
668,Thibault De Smet,BEL,DF,Reims,Ligue 1,24,1998,19.5,24,17,10,14,0,11,37,29.7,26,28,5,23,20,44,40,1,Matches
669,Koni De Winter,BEL,DF,Empoli,Serie A,20,2002,11.4,14,9,11,3,0,5,13,38.5,8,14,12,2,6,20,65,0,Matches
670,Grégoire Defrel,MTQ,FW,Sassuolo,Serie A,31,1991,13.0,9,7,5,2,2,4,13,30.8,9,11,0,11,2,11,5,0,Matches
671,Duccio Degl'Innocenti,ITA,MF,Empoli,Serie A,19,2003,0.0,0,0,0,0,0,0,0,0.0,0,0,0,0,1,1,0,0,Matches
672,Brecht Dejaegere,BEL,MF,Toulouse,Ligue 1,31,1991,20.1,40,23,10,20,10,15,51,29.4,36,25,5,20,14,54,11,0,Matches
673,Romain Del Castillo,FRA,"MF,FW",Brest,Ligue 1,26,1996,15.8,39,24,13,17,9,16,36,44.4,20,14,1,13,11,50,5,0,Matches
674,Alberto Del Moral,ESP,MF,Villarreal,La Liga,22,2000,0.1,0,0,0,0,0,0,0,0.0,0,0,0,0,0,0,0,0,Matches
675,Thomas Delaine,FRA,"DF,MF",Strasbourg,Ligue 1,30,1992,11.9,28,14,16,6,6,13,26,50.0,13,8,3,5,16,44,9,0,Matches
676,Thomas Delaney,DEN,MF,Sevilla,La Liga,30,1991,3.4,4,2,0,4,0,3,5,60.0,2,3,2,1,4,8,3,0,Matches
677,Thomas Delaney,DEN,MF,Hoffenheim,Bundesliga,30,1991,3.3,6,3,3,2,1,3,8,37.5,5,5,0,5,1,7,4,0,Matches
678,Sacha Delaye,FRA,"FW,MF",Montpellier,Ligue 1,20,2002,0.2,1,0,0,0,1,1,1,100.0,0,0,0,0,0,1,0,0,Matches
679,Fran Delgado,ESP,DF,Betis,La Liga,21,2001,0.1,0,0,0,0,0,0,0,0.0,0,0,0,0,0,0,0,0,Matches
680,Andy Delort,ALG,FW,Nice,Ligue 1,30,1991,8.7,2,0,1,1,0,1,2,50.0,1,0,0,0,1,3,7,0,Matches
681,Andy Delort,ALG,FW,Nantes,Ligue 1,30,1991,5.2,5,4,1,2,2,2,6,33.3,4,3,0,3,0,5,2,0,Matches
682,Karamoko Dembele,SCO,"FW,MF",Brest,Ligue 1,19,2003,2.0,2,0,1,1,0,2,2,100.0,0,1,0,1,1,3,0,0,Matches
683,Moussa Dembélé,FRA,"FW,MF",Lyon,Ligue 1,26,1996,9.7,8,4,3,3,2,4,7,57.1,3,5,0,5,2,10,6,0,Matches
684,Ousmane Dembélé,FRA,FW,Barcelona,La Liga,25,1997,15.7,19,12,4,8,7,4,15,26.7,11,10,1,9,0,19,2,0,Matches
685,Siriki Dembélé,CIV,"FW,MF",Bournemouth,Premier League,25,1996,1.2,3,1,2,1,0,0,1,0.0,1,1,0,1,1,4,1,0,Matches
686,Siriki Dembélé,CIV,"MF,FW",Auxerre,Ligue 1,25,1996,4.1,10,6,4,3,3,4,12,33.3,8,2,0,2,1,11,2,0,Matches
687,Merih Demiral,TUR,DF,Atalanta,Serie A,24,1998,17.1,41,29,30,11,0,26,36,72.2,10,24,7,17,24,65,57,1,Matches
688,Kerem Demirbay,GER,MF,Leverkusen,Bundesliga,29,1993,17.2,36,18,16,17,3,18,34,52.9,16,26,6,20,16,52,11,0,Matches
689,Ermedin Demirović,BIH,"FW,MF",Augsburg,Bundesliga,24,1998,26.3,31,14,9,12,10,9,22,40.9,13,31,4,27,14,45,37,0,Matches
690,Diego Demme,GER,MF,Napoli,Serie A,30,1991,1.6,1,0,1,0,0,0,4,0.0,4,2,0,2,0,1,1,0,Matches
691,Sepp van den Berg,NED,DF,Schalke 04,Bundesliga,20,2001,7.7,5,4,2,2,1,1,4,25.0,3,8,5,3,13,18,33,2,Matches
692,Branco van den Boomen,NED,MF,Toulouse,Ligue 1,27,1995,32.1,71,36,26,32,13,36,89,40.4,53,27,4,23,10,81,27,2,Matches
693,Leander Dendoncker,BEL,MF,Aston Villa,Premier League,27,1995,7.7,19,9,11,6,2,11,21,52.4,10,19,4,15,10,29,12,0,Matches
694,Leander Dendoncker,BEL,MF,Wolves,Premier League,27,1995,2.4,4,2,0,3,1,2,3,66.7,1,2,0,2,9,13,4,0,Matches
695,Emmanuel Dennis,NGA,"FW,MF",Nott'ham Forest,Premier League,24,1997,8.0,17,11,5,5,7,8,17,47.1,9,13,1,12,2,19,6,0,Matches
696,Fabio Depaoli,ITA,DF,Hellas Verona,Serie A,25,1997,24.1,48,28,25,16,7,25,44,56.8,19,32,6,26,18,66,33,3,Matches
697,Fabio Depaoli,ITA,"DF,MF",Sampdoria,Serie A,25,1997,1.5,5,3,2,3,0,3,4,75.0,1,1,0,1,1,6,4,0,Matches
698,Kastriot Dermaku,ALB,DF,Lecce,Serie A,30,1992,0.4,0,0,0,0,0,0,0,0.0,0,0,0,0,0,0,0,0,Matches
699,Halil Dervişoğlu,TUR,MF,Brentford,Premier League,22,1999,0.1,0,0,0,0,0,0,1,0.0,1,0,0,0,0,0,0,0,Matches
700,Rémy Descamps,FRA,GK,Nantes,Ligue 1,26,1996,1.0,0,0,0,0,0,0,0,0.0,0,0,0,0,0,0,0,0,Matches
701,Mikkel Desler,DEN,DF,Toulouse,Ligue 1,27,1995,25.1,71,38,36,27,8,43,67,64.2,24,35,6,29,36,107,48,2,Matches
702,Cyriel Dessers,NGA,FW,Cremonese,Serie A,27,1994,17.6,11,4,4,4,3,2,6,33.3,4,14,2,12,3,14,5,0,Matches
703,Sergiño Dest,USA,DF,Milan,Serie A,21,2000,3.7,12,6,3,5,4,3,4,75.0,1,1,0,1,4,16,2,0,Matches
704,Mattia Destro,ITA,"FW,MF",Empoli,Serie A,31,1991,6.4,1,1,0,1,0,0,0,0.0,0,2,0,2,1,2,5,0,Matches
705,Gerard Deulofeu,ESP,FW,Udinese,Serie A,28,1994,13.5,8,5,5,1,2,5,15,33.3,10,8,1,7,2,10,1,0,Matches
706,Kiernan Dewsbury-Hall,ENG,MF,Leicester City,Premier League,23,1998,25.6,53,29,14,34,5,19,47,40.4,28,55,13,42,28,81,21,0,Matches
707,Samuel Di Carmine,ITA,"FW,MF",Cremonese,Serie A,33,1988,0.3,0,0,0,0,0,0,0,0.0,0,0,0,0,0,0,0,0,Matches
708,Federico Di Francesco,ITA,"FW,MF",Lecce,Serie A,28,1994,22.6,28,16,7,11,10,9,19,47.4,10,16,0,16,8,36,14,0,Matches
709,Michele Di Gregorio,ITA,GK,Monza,Serie A,25,1997,37.0,0,0,0,0,0,0,3,0.0,3,1,0,1,4,4,18,3,Matches
710,Giovanni Di Lorenzo,ITA,DF,Napoli,Serie A,28,1993,36.2,60,29,33,19,8,25,49,51.0,24,30,9,21,30,90,60,0,Matches
711,Ángel Di María,ARG,"FW,MF",Juventus,Serie A,34,1988,15.1,10,5,3,5,2,3,19,15.8,16,15,0,15,7,17,0,0,Matches
712,Boulaye Dia,SEN,"FW,MF",Salernitana,Serie A,25,1996,28.0,12,5,3,6,3,2,7,28.6,5,10,0,10,7,19,27,1,Matches
713,Moussa Diaby,FRA,"FW,MF",Leverkusen,Bundesliga,23,1999,30.0,14,8,4,8,2,7,14,50.0,7,8,0,8,5,19,3,0,Matches
714,Mouctar Diakhaby,GUI,DF,Valencia,La Liga,25,1996,27.2,30,16,19,11,0,13,20,65.0,7,30,17,13,20,50,111,2,Matches
715,Mamadou Diakhon,FRA,FW,Reims,Ligue 1,16,2005,0.2,2,0,2,0,0,0,1,0.0,1,1,0,1,1,3,0,0,Matches
716,Bafodé Diakité,FRA,DF,Lille,Ligue 1,21,2001,29.5,54,35,23,24,7,32,57,56.1,25,37,8,29,17,71,58,0,Matches
717,Ibrahim Diakité,GUI,DF,Reims,Ligue 1,18,2003,1.5,3,3,3,0,0,2,3,66.7,1,0,0,0,5,8,6,0,Matches
718,Abdou Diallo,SEN,"DF,MF",RB Leipzig,Bundesliga,26,1996,5.3,6,5,5,1,0,1,3,33.3,2,8,5,3,8,14,22,0,Matches
719,Baila Diallo,FRA,"DF,MF",Clermont Foot,Ligue 1,21,2001,1.0,1,0,1,0,0,0,0,0.0,0,1,1,0,0,1,1,0,Matches
720,Habib Diallo,SEN,FW,Strasbourg,Ligue 1,27,1995,32.0,18,10,8,7,3,6,16,37.5,10,19,4,15,12,30,26,0,Matches
721,Ibrahima Diallo,FRA,MF,Southampton,Premier League,23,1999,9.1,25,15,14,10,1,8,14,57.1,6,11,1,10,6,31,11,0,Matches
722,Ismael Diallo,CIV,DF,Ajaccio,Ligue 1,25,1997,24.2,46,33,35,9,2,35,63,55.6,28,26,12,14,30,76,46,1,Matches
723,Mamady Diarra,MLI,"MF,DF",Cádiz,La Liga,22,2000,0.7,2,1,2,0,0,1,2,50.0,1,2,0,2,0,2,0,0,Matches
724,Mouhamadou Diarra,FRA,"MF,FW",Strasbourg,Ligue 1,18,2004,18.1,24,16,10,11,3,15,29,51.7,14,17,1,16,11,35,13,0,Matches
725,Moussa Diarra,MLI,DF,Toulouse,Ligue 1,21,2000,13.6,20,9,9,9,2,9,15,60.0,6,25,10,15,19,39,27,1,Matches
726,Stéphane Diarra,FRA,"FW,MF",Lorient,Ligue 1,23,1998,11.8,25,17,14,9,2,11,29,37.9,18,13,1,12,22,47,9,0,Matches
727,Youba Diarra,MLI,MF,Cádiz,La Liga,24,1998,1.1,3,0,2,1,0,1,5,20.0,4,7,1,6,2,5,3,0,Matches
728,Rúben Dias,POR,DF,Manchester City,Premier League,25,1997,22.2,21,13,10,10,1,11,18,61.1,7,21,13,8,18,39,56,1,Matches
729,Krépin Diatta,SEN,"MF,FW",Monaco,Ligue 1,23,1999,23.0,30,21,4,17,9,13,32,40.6,19,29,1,28,17,47,12,0,Matches
730,Mory Diaw,SEN,GK,Clermont Foot,Ligue 1,29,1993,37.0,0,0,0,0,0,0,4,0.0,4,0,0,0,2,2,13,5,Matches
731,Brahim Díaz,ESP,"MF,FW",Milan,Serie A,22,1999,21.4,32,15,5,22,5,5,15,33.3,10,11,0,11,7,39,6,0,Matches
732,Luis Díaz,COL,FW,Liverpool,Premier League,25,1997,11.1,17,11,4,8,5,8,15,53.3,7,8,0,8,6,23,2,0,Matches
733,Justin Diehl,GER,"MF,FW",Köln,Bundesliga,17,2004,0.2,0,0,0,0,0,0,0,0.0,0,0,0,0,0,0,0,0,Matches
734,Bamba Dieng,SEN,"FW,MF",Marseille,Ligue 1,22,2000,2.2,4,4,2,1,1,3,4,75.0,1,5,1,4,0,4,0,0,Matches
735,Bamba Dieng,SEN,FW,Lorient,Ligue 1,22,2000,8.3,19,10,5,12,2,3,11,27.3,8,6,0,6,2,21,6,0,Matches
736,Eric Dier,ENG,DF,Tottenham,Premier League,28,1994,31.3,30,19,16,12,2,9,19,47.4,10,41,24,17,35,65,112,2,Matches
737,Florian Dietz,GER,FW,Köln,Bundesliga,23,1998,4.4,2,1,0,2,0,1,4,25.0,3,4,1,3,0,2,2,0,Matches
738,Lucas Digne,FRA,DF,Aston Villa,Premier League,29,1993,16.7,30,12,20,9,1,20,33,60.6,13,18,5,13,18,48,45,0,Matches
739,Federico Dimarco,ITA,DF,Inter,Serie A,24,1997,23.0,31,25,6,18,7,9,19,47.4,10,15,4,11,18,49,20,0,Matches
740,Stole Dimitrievski,MKD,GK,Rayo Vallecano,La Liga,28,1993,36.9,1,0,1,0,0,1,2,50.0,1,2,0,2,1,2,17,3,Matches
741,Junior Dina Ebimbe,FRA,"DF,MF",Eint Frankfurt,Bundesliga,21,2000,11.8,30,19,16,14,0,16,33,48.5,17,18,5,13,11,41,20,0,Matches
742,Tristan Dingomé,CMR,MF,Troyes,Ligue 1,31,1991,1.1,1,1,0,1,0,0,2,0.0,2,0,0,0,0,1,0,0,Matches
743,Eren Dinkçi,GER,"FW,MF",Werder Bremen,Bundesliga,20,2001,2.6,5,5,2,1,2,2,6,33.3,4,2,0,2,0,5,2,0,Matches
744,Sinaly Diomande,CIV,DF,Lyon,Ligue 1,21,2001,21.7,42,24,26,15,1,31,49,63.3,18,26,13,13,49,91,75,1,Matches
745,Lois Diony,FRA,FW,Angers,Ligue 1,29,1992,5.6,1,0,0,1,0,1,3,33.3,2,2,0,2,0,1,1,0,Matches
746,Edan Diop,FRA,"DF,FW",Monaco,Ligue 1,17,2004,2.5,13,8,3,3,7,7,15,46.7,8,7,1,6,4,17,1,0,Matches
747,Issa Diop,FRA,DF,Fulham,Premier League,25,1997,22.4,28,19,18,9,1,17,32,53.1,15,24,17,7,35,63,86,0,Matches
748,Sofiane Diop,FRA,"MF,FW",Nice,Ligue 1,22,2000,13.6,23,11,12,6,5,7,20,35.0,13,14,2,12,16,39,5,0,Matches
749,Sofiane Diop,FRA,MF,Monaco,Ligue 1,22,2000,0.7,0,0,0,0,0,0,0,0.0,0,0,0,0,1,1,0,0,Matches
750,Yehvann Diouf,FRA,GK,Reims,Ligue 1,22,1999,31.0,2,0,2,0,0,1,3,33.3,2,0,0,0,1,3,13,5,Matches
751,Axel Disasi,FRA,DF,Monaco,Ligue 1,24,1998,37.0,30,20,13,13,4,13,27,48.1,14,51,31,20,56,86,112,2,Matches
752,Tiago Djaló,POR,DF,Lille,Ligue 1,22,2000,22.4,31,21,23,7,1,13,20,65.0,7,17,11,6,23,54,60,1,Matches
753,Djené,TOG,DF,Getafe,La Liga,30,1991,31.6,41,28,23,17,1,22,38,57.9,16,25,10,15,42,83,81,1,Matches
754,Moussa Djenepo,MLI,"DF,FW",Southampton,Premier League,24,1998,7.9,19,11,13,5,1,11,26,42.3,15,19,2,17,11,30,7,0,Matches
755,Koffi Djidji,CIV,DF,Torino,Serie A,29,1992,26.9,50,25,32,17,1,18,32,56.3,14,29,14,15,34,84,72,0,Matches
756,Alexander Djiku,GHA,DF,Strasbourg,Ligue 1,27,1994,29.7,53,36,37,16,0,26,46,56.5,20,45,19,26,66,119,151,3,Matches
757,Berat Djimsiti,ALB,DF,Atalanta,Serie A,29,1993,20.0,34,19,21,13,0,17,25,68.0,8,17,7,10,36,70,74,1,Matches
758,Moussa Djitte,SEN,FW,Ajaccio,Ligue 1,22,1999,1.5,1,0,0,0,1,1,2,50.0,1,0,0,0,0,1,1,0,Matches
759,Ouparine Djoco,GNB,GK,Clermont Foot,Ligue 1,24,1998,1.0,0,0,0,0,0,0,0,0.0,0,0,0,0,0,0,1,0,Matches
760,Marko Dmitrović,SRB,GK,Sevilla,La Liga,30,1992,14.1,0,0,0,0,0,0,0,0.0,0,0,0,0,0,0,6,0,Matches
761,Alan Do Marcolino,GAB,FW,Rennes,Ligue 1,20,2002,0.2,0,0,0,0,0,0,0,0.0,0,0,0,0,0,0,1,0,Matches
762,Ben Doak,SCO,FW,Liverpool,Premier League,16,2005,0.3,3,2,1,2,0,1,1,100.0,0,1,0,1,0,3,0,0,Matches
763,Ritsu Doan,JPN,"MF,FW",Freiburg,Bundesliga,24,1998,26.9,61,29,19,29,13,25,54,46.3,29,40,1,39,14,75,12,0,Matches
764,Dodô,BRA,DF,Fiorentina,Serie A,23,1998,25.9,40,22,20,14,6,22,46,47.8,24,26,2,24,25,65,37,0,Matches
765,Danilho Doekhi,NED,DF,Union Berlin,Bundesliga,24,1998,24.6,38,23,21,17,0,14,26,53.8,12,27,12,15,29,67,93,0,Matches
766,Matt Doherty,IRL,"DF,MF",Tottenham,Premier League,30,1992,7.4,16,10,12,3,1,8,10,80.0,2,11,6,5,8,24,14,1,Matches
767,Matt Doherty,IRL,DF,Atlético Madrid,La Liga,30,1992,0.2,0,0,0,0,0,0,0,0.0,0,2,0,2,0,0,0,0,Matches
768,Josh Doig,SCO,DF,Hellas Verona,Serie A,20,2002,15.0,19,8,6,7,6,6,16,37.5,10,25,6,19,11,30,13,1,Matches
769,Jeremy Doku,BEL,"MF,FW",Rennes,Ligue 1,20,2002,14.3,25,16,6,13,6,12,24,50.0,12,10,0,10,5,30,2,0,Matches
770,Kasper Dolberg,DEN,FW,Sevilla,La Liga,24,1997,2.2,1,0,0,1,0,1,3,33.3,2,0,0,0,0,1,5,0,Matches
771,Kasper Dolberg,DEN,"FW,MF",Hoffenheim,Bundesliga,24,1997,4.5,7,5,1,4,2,4,6,66.7,2,6,2,4,0,7,5,0,Matches
772,Carlos Dominguez,ESP,DF,Celta Vigo,La Liga,21,2001,1.2,1,1,0,1,0,1,2,50.0,1,1,1,0,0,1,7,0,Matches
773,Nicolás Domínguez,ARG,MF,Bologna,Serie A,24,1998,25.6,79,49,34,33,12,39,76,51.3,37,29,3,26,21,100,29,1,Matches
774,John Donald,ESP,"MF,DF",Elche,La Liga,21,2000,12.1,20,11,9,9,2,7,14,50.0,7,14,7,7,14,34,23,1,Matches
775,Giulio Donati,ITA,DF,Monza,Serie A,32,1990,4.7,4,1,1,1,2,3,6,50.0,3,3,1,2,4,8,11,0,Matches
776,Kyliane Dong,FRA,"MF,FW",Troyes,Ligue 1,17,2004,2.4,3,1,0,2,1,1,2,50.0,1,1,0,1,1,4,0,0,Matches
777,Jordan Dongmo,CMR,MF,Troyes,Ligue 1,21,2001,0.2,1,0,0,1,0,1,1,100.0,0,0,0,0,0,1,0,0,Matches
778,Gianluigi Donnarumma,ITA,GK,Paris S-G,Ligue 1,23,1999,37.9,1,0,1,0,0,1,2,50.0,1,0,0,0,0,1,12,4,Matches
779,Niklas Dorsch,GER,MF,Augsburg,Bundesliga,24,1998,5.4,21,12,8,11,2,9,16,56.3,7,9,3,6,6,27,9,0,Matches
780,Gabriel Dos Santos,BRA,DF,Arsenal,Premier League,24,1997,37.9,48,30,29,15,4,18,27,66.7,9,49,26,23,32,80,125,2,Matches
781,Jodel Dossou,BEN,"MF,DF",Clermont Foot,Ligue 1,30,1992,2.9,7,4,3,2,2,4,4,100.0,0,2,1,1,1,8,0,0,Matches
782,Lohann Doucet,FRA,"MF,FW",Nantes,Ligue 1,19,2002,1.0,3,0,2,0,1,3,4,75.0,1,2,0,2,2,5,4,0,Matches
783,Abdoulaye Doucouré,MLI,MF,Everton,Premier League,29,1993,17.0,31,20,9,15,7,12,37,32.4,25,26,3,23,13,44,11,0,Matches
784,Cheick Doucouré,MLI,MF,Crystal Palace,Premier League,22,2000,30.8,77,46,40,33,4,29,52,55.8,23,47,13,34,56,133,48,0,Matches
785,Ckene Doucouré,COM,"FW,MF",Lorient,Ligue 1,20,2002,1.5,2,2,2,0,0,1,2,50.0,1,0,0,0,1,3,0,0,Matches
786,Désiré Doué,FRA,"MF,FW",Rennes,Ligue 1,17,2005,12.4,37,18,10,23,4,13,32,40.6,19,17,1,16,13,50,3,0,Matches
787,Guela Doué,FRA,"FW,MF",Rennes,Ligue 1,19,2002,0.1,0,0,0,0,0,0,0,0.0,0,0,0,0,0,0,0,0,Matches
788,Ismaël Doukouré,FRA,"DF,MF",Strasbourg,Ligue 1,19,2003,25.5,48,24,23,21,4,20,34,58.8,14,26,8,18,27,75,54,0,Matches
789,Kamory Doumbia,MLI,MF,Reims,Ligue 1,19,2003,12.8,31,16,9,14,8,12,37,32.4,25,17,1,16,13,44,3,0,Matches
790,Souleyman Doumbia,CIV,"DF,FW",Angers,Ligue 1,25,1996,19.9,45,31,31,13,1,17,31,54.8,14,20,3,17,27,72,27,1,Matches
791,Flynn Downes,ENG,MF,West Ham,Premier League,23,1999,8.5,16,9,4,10,2,6,12,50.0,6,15,2,13,7,23,6,0,Matches
792,Kami Doyle,ENG,MF,Southampton,Premier League,16,2005,0.1,0,0,0,0,0,0,0,0.0,0,0,0,0,0,0,0,0,Matches
793,Bartłomiej Drągowski,POL,GK,Spezia,Serie A,24,1997,32.7,1,0,1,0,0,1,5,20.0,4,0,0,0,1,2,15,3,Matches
794,Cody Drameh,ENG,DF,Leeds United,Premier League,20,2001,0.8,5,4,0,4,1,2,3,66.7,1,0,0,0,1,6,1,0,Matches
795,Dion Drena Beljo,CRO,FW,Augsburg,Bundesliga,20,2002,12.5,7,6,3,2,2,2,13,15.4,11,15,2,13,1,8,14,0,Matches
796,Dominick Drexler,GER,"MF,FW",Schalke 04,Bundesliga,32,1990,15.2,25,17,12,10,3,9,22,40.9,13,18,2,16,8,33,12,0,Matches
797,Domingos Duarte,POR,DF,Getafe,La Liga,27,1995,29.5,26,18,21,5,0,19,26,73.1,7,29,23,6,39,65,145,0,Matches
798,Martin Dúbravka,SVK,GK,Newcastle Utd,Premier League,33,1989,1.7,0,0,0,0,0,0,1,0.0,1,0,0,0,0,0,1,0,Matches
799,Marvin Ducksch,GER,FW,Werder Bremen,Bundesliga,28,1994,31.7,8,3,2,4,2,3,16,18.8,13,13,2,11,9,17,41,1,Matches
800,Ondrej Duda,SVK,MF,Hellas Verona,Serie A,27,1994,11.8,22,14,7,12,3,9,16,56.3,7,11,0,11,13,35,8,0,Matches
801,Ondrej Duda,SVK,MF,Köln,Bundesliga,27,1994,7.7,9,8,2,5,2,4,11,36.4,7,7,1,6,2,11,3,0,Matches
802,Shane Duffy,IRL,"DF,FW",Fulham,Premier League,30,1992,0.2,0,0,0,0,0,0,0,0.0,0,0,0,0,0,0,0,1,Matches
803,Rémy Dugimont,FRA,"FW,MF",Auxerre,Ligue 1,36,1986,1.3,2,1,0,1,1,1,2,50.0,1,3,0,3,0,2,5,0,Matches
804,Denzel Dumfries,NED,DF,Inter,Serie A,26,1996,24.6,35,18,17,13,5,22,34,64.7,12,33,9,24,12,47,26,0,Matches
805,Alfred Duncan,GHA,MF,Fiorentina,Serie A,29,1993,12.3,18,10,0,17,1,10,21,47.6,11,9,0,9,8,26,6,0,Matches
806,Lewis Dunk,ENG,DF,Brighton,Premier League,30,1991,36.0,30,19,19,9,2,18,41,43.9,23,37,27,10,34,64,81,1,Matches
807,Maxime Dupé,FRA,GK,Toulouse,Ligue 1,29,1993,38.0,0,0,0,0,0,0,0,0.0,0,0,0,0,0,0,9,3,Matches
808,Jhon Durán,COL,"FW,MF",Aston Villa,Premier League,18,2003,1.5,2,2,0,1,1,1,4,25.0,3,0,0,0,2,4,2,0,Matches
809,Pablo Durán,ESP,"MF,DF",Celta Vigo,La Liga,21,2001,0.4,0,0,0,0,0,0,0,0.0,0,2,1,1,1,1,2,0,Matches
810,Julien Duranville,BEL,MF,Dortmund,Bundesliga,16,2006,0.3,1,1,0,1,0,1,1,100.0,0,0,0,0,0,1,0,0,Matches
811,Hugo Duro,ESP,FW,Valencia,La Liga,22,1999,15.4,15,12,2,6,7,7,17,41.2,10,11,1,10,2,17,7,1,Matches
812,Jean-Kevin Duverne,HAI,DF,Brest,Ligue 1,25,1997,27.9,72,38,44,24,4,42,73,57.5,31,33,5,28,28,100,65,1,Matches
813,Paulo Dybala,ARG,"MF,FW",Roma,Serie A,28,1993,19.3,14,4,1,8,5,8,26,30.8,18,12,1,11,8,22,4,0,Matches
814,Edin Džeko,BIH,FW,Inter,Serie A,36,1986,19.2,3,2,0,3,0,0,4,0.0,4,15,1,14,3,6,25,0,Matches
815,Malcolm Ebiowei,ENG,"MF,FW",Crystal Palace,Premier League,18,2003,0.4,1,1,1,0,0,0,1,0.0,1,2,0,2,0,1,0,0,Matches
816,Festy Ebosele,IRL,DF,Udinese,Serie A,19,2002,4.6,15,10,8,7,0,4,10,40.0,6,5,0,5,2,17,5,0,Matches
817,Enzo Ebosse,CMR,DF,Udinese,Serie A,23,1999,10.3,15,9,11,4,0,9,13,69.2,4,27,6,21,11,26,29,0,Matches
818,Tyronne Ebuehi,NGA,DF,Empoli,Serie A,26,1995,21.4,22,14,11,7,4,9,13,69.2,4,23,12,11,12,34,79,1,Matches
819,Ederson,BRA,GK,Manchester City,Premier League,28,1993,35.0,3,1,3,0,0,1,2,50.0,1,0,0,0,1,4,10,2,Matches
820,Éderson,BRA,MF,Atalanta,Serie A,23,1999,24.6,67,34,18,42,7,29,66,43.9,37,56,7,49,36,103,31,0,Matches
821,Odsonne Édouard,FRA,FW,Crystal Palace,Premier League,24,1998,20.0,25,13,7,12,6,7,13,53.8,6,17,5,12,3,28,22,0,Matches
822,Samuel Edozie,ENG,"FW,MF",Southampton,Premier League,19,2003,6.3,17,10,6,10,1,3,8,37.5,5,7,0,7,6,23,6,0,Matches
823,Maximilian Eggestein,GER,MF,Freiburg,Bundesliga,25,1996,27.2,51,29,21,24,6,17,35,48.6,18,37,8,29,36,87,27,0,Matches
824,Lilian Egloff,GER,"MF,FW",Stuttgart,Bundesliga,19,2002,2.7,12,10,4,5,3,4,6,66.7,2,2,0,2,1,13,1,0,Matches
825,Íñigo Eguaras,ESP,MF,Almería,La Liga,30,1992,10.7,11,8,4,6,1,5,18,27.8,13,9,3,6,6,17,15,0,Matches
826,Kingsley Ehizibue,NED,DF,Udinese,Serie A,27,1995,17.1,47,31,28,13,6,29,45,64.4,16,21,3,18,10,57,42,1,Matches
827,Kingsley Ehizibue,NED,DF,Köln,Bundesliga,27,1995,0.7,0,0,0,0,0,0,0,0.0,0,1,0,1,2,2,1,0,Matches
828,Julian Eitschberger,GER,FW,Hertha BSC,Bundesliga,18,2004,0.0,0,0,0,0,0,0,0,0.0,0,0,0,0,0,0,0,0,Matches
829,Chidera Ejuke,NGA,"FW,MF",Hertha BSC,Bundesliga,24,1998,9.9,5,4,1,4,0,1,5,20.0,4,4,0,4,4,9,1,0,Matches
830,Albin Ekdal,SWE,MF,Spezia,Serie A,33,1989,19.3,37,20,14,20,3,19,45,42.2,26,24,2,22,26,63,36,0,Matches
831,Hugo Ekitike,FRA,FW,Paris S-G,Ligue 1,20,2002,12.8,12,4,1,10,1,4,12,33.3,8,12,0,12,9,21,3,0,Matches
832,Emmanuel Ekong,SWE,"FW,MF",Empoli,Serie A,20,2002,0.2,0,0,0,0,0,0,0,0.0,0,0,0,0,0,0,0,0,Matches
833,Anthony Elanga,SWE,FW,Manchester Utd,Premier League,20,2002,4.7,3,0,0,2,1,1,2,50.0,1,4,0,4,2,5,4,0,Matches
834,Alberth Elis,HON,"MF,FW",Brest,Ligue 1,26,1996,2.9,4,3,1,2,1,1,7,14.3,6,1,0,1,1,5,2,0,Matches
835,Mikael Ellertsson,ISL,"MF,DF",Spezia,Serie A,20,2002,1.9,4,2,1,3,0,0,3,0.0,3,2,1,1,2,6,0,0,Matches
836,Harvey Elliott,ENG,"MF,FW",Liverpool,Premier League,19,2003,17.9,27,18,6,12,9,9,36,25.0,27,26,1,25,15,42,8,0,Matches
837,Elif Elmas,MKD,"FW,MF",Napoli,Serie A,22,1999,18.1,24,13,8,12,4,11,23,47.8,12,18,2,16,11,35,5,0,Matches
838,Mohamed Elneny,EGY,MF,Arsenal,Premier League,30,1992,1.3,1,1,1,0,0,1,1,100.0,0,0,0,0,0,1,0,0,Matches
839,Aritz Elustondo,ESP,DF,Real Sociedad,La Liga,28,1994,16.1,26,17,15,10,1,14,26,53.8,12,15,6,9,20,46,43,1,Matches
840,Nico Elvedi,SUI,DF,M'Gladbach,Bundesliga,25,1996,31.4,46,24,32,12,2,27,41,65.9,14,31,16,15,35,81,149,3,Matches
841,Rodrigo Ely,BRA,DF,Almería,La Liga,28,1993,35.1,30,21,26,4,0,18,25,72.0,7,46,33,13,31,61,203,1,Matches
842,Mohamed Elyounoussi,NOR,"MF,FW",Southampton,Premier League,27,1994,24.1,46,28,22,20,4,19,43,44.2,24,40,3,37,27,73,37,0,Matches
843,Adri Embarba,ESP,"FW,MF",Almería,La Liga,30,1992,16.4,50,27,21,26,3,22,46,47.8,24,23,0,23,9,59,9,0,Matches
844,Adri Embarba,ESP,FW,Espanyol,La Liga,30,1992,0.4,1,0,0,1,0,1,1,100.0,0,1,0,1,0,1,0,0,Matches
845,Breel Embolo,SUI,FW,Monaco,Ligue 1,25,1997,20.7,15,9,2,7,6,5,10,50.0,5,14,3,11,5,20,12,0,Matches
846,Emerson,BRA,DF,Tottenham,Premier League,23,1999,19.3,54,33,38,12,4,27,40,67.5,13,17,3,14,18,72,75,0,Matches
847,Youssef En-Nesyri,MAR,FW,Sevilla,La Liga,25,1997,18.5,16,8,3,7,6,4,14,28.6,10,6,2,4,4,20,16,0,Matches
848,Wataru Endo,JPN,MF,Stuttgart,Bundesliga,29,1993,32.5,70,37,30,31,9,38,85,44.7,47,44,6,38,26,96,63,0,Matches
849,Arne Engels,BEL,MF,Augsburg,Bundesliga,18,2003,16.0,20,9,9,10,1,8,19,42.1,11,17,5,12,15,35,12,1,Matches
850,Christian Eriksen,DEN,MF,Manchester Utd,Premier League,30,1992,22.8,22,18,10,7,5,10,32,31.3,22,23,9,14,11,33,20,1,Matches
851,Martin Erlic,CRO,DF,Sassuolo,Serie A,24,1998,25.9,27,16,18,8,1,10,23,43.5,13,36,23,13,31,58,120,1,Matches
852,Tjark Ernst,GER,GK,Hertha BSC,Bundesliga,19,2003,1.0,0,0,0,0,0,0,0,0.0,0,0,0,0,0,0,1,0,Matches
853,Gonzalo Escalante,ARG,MF,Cremonese,Serie A,29,1993,6.2,16,8,8,8,0,10,13,76.9,3,7,1,6,10,26,4,0,Matches
854,Gonzalo Escalante,ARG,MF,Cádiz,La Liga,29,1993,12.5,36,24,15,20,1,15,29,51.7,14,18,4,14,17,53,26,1,Matches
855,Sergio Escudero,ESP,DF,Valladolid,La Liga,32,1989,16.0,33,19,21,8,4,15,35,42.9,20,26,6,20,26,59,46,0,Matches
856,Alfonso Espino,URU,DF,Cádiz,La Liga,30,1992,34.7,87,56,55,20,12,48,96,50.0,48,52,11,41,48,135,99,3,Matches
857,Bernardo Espinosa,COL,DF,Girona,La Liga,33,1989,13.6,6,2,2,4,0,3,9,33.3,6,17,10,7,12,18,70,2,Matches
858,Salvatore Esposito,ITA,MF,Spezia,Serie A,21,2000,10.8,15,12,8,5,2,5,21,23.8,16,9,1,8,11,26,18,0,Matches
859,Maxime Estève,FRA,DF,Montpellier,Ligue 1,20,2002,18.3,24,13,17,5,2,12,17,70.6,5,28,17,11,34,58,90,0,Matches
860,Pervis Estupiñán,ECU,DF,Brighton,Premier League,24,1998,29.7,61,31,36,19,6,35,60,58.3,25,30,8,22,37,98,37,1,Matches
861,Jonny Evans,NIR,DF,Leicester City,Premier League,34,1988,11.7,13,5,12,1,0,7,11,63.6,4,15,11,4,18,31,51,0,Matches
862,Edu Expósito,ESP,MF,Espanyol,La Liga,25,1996,12.9,34,20,16,15,3,13,23,56.5,10,7,0,7,12,46,20,0,Matches
863,Eberechi Eze,ENG,"MF,FW",Crystal Palace,Premier League,24,1998,29.3,42,24,17,18,7,18,38,47.4,20,22,0,22,13,55,10,0,Matches
864,Kimberly Ezekwem,GER,DF,Freiburg,Bundesliga,21,2001,0.1,0,0,0,0,0,0,0,0.0,0,1,0,1,0,0,0,0,Matches
865,Nicolás Ezequiel Fernández,ARG,"MF,DF",Elche,La Liga,22,2000,5.7,23,12,10,7,6,9,17,52.9,8,7,0,7,5,28,2,1,Matches
866,Abdessamad Ezzalzouli,MAR,"FW,MF",Osasuna,La Liga,20,2001,16.7,29,19,13,12,4,13,23,56.5,10,20,0,20,4,33,6,0,Matches
867,Łukasz Fabiański,POL,GK,West Ham,Premier League,37,1985,34.6,2,0,2,0,0,1,2,50.0,1,1,0,1,0,2,10,1,Matches
868,Fabinho,BRA,MF,Liverpool,Premier League,28,1993,29.7,65,38,18,40,7,24,62,38.7,38,38,11,27,37,102,40,0,Matches
869,Fábio,BRA,"DF,MF",Nantes,Ligue 1,32,1990,2.5,4,2,1,2,1,4,6,66.7,2,2,0,2,3,7,11,0,Matches
870,Noah Fadiga,SEN,DF,Brest,Ligue 1,22,1999,14.5,30,21,18,9,3,14,26,53.8,12,17,7,10,26,56,18,0,Matches
871,Wout Faes,BEL,DF,Leicester City,Premier League,24,1998,31.0,56,33,28,26,2,28,44,63.6,16,53,37,16,41,97,113,2,Matches
872,Wout Faes,BEL,DF,Reims,Ligue 1,24,1998,3.0,1,1,1,0,0,1,2,50.0,1,6,3,3,7,8,19,0,Matches
873,Nicolò Fagioli,ITA,MF,Juventus,Serie A,21,2001,16.9,29,19,12,15,2,8,27,29.6,19,16,2,14,8,37,7,1,Matches
874,Ralf Fährmann,GER,GK,Schalke 04,Bundesliga,33,1988,11.4,1,0,1,0,0,1,1,100.0,0,0,0,0,0,1,10,2,Matches
875,Romain Faivre,FRA,"MF,FW",Lorient,Ligue 1,24,1998,13.8,13,8,5,4,4,5,25,20.0,20,11,0,11,1,14,4,0,Matches
876,Romain Faivre,FRA,MF,Lyon,Ligue 1,24,1998,3.3,6,3,2,2,2,1,3,33.3,2,3,0,3,0,6,0,0,Matches
877,Radamel Falcao,COL,"FW,MF",Rayo Vallecano,La Liga,36,1986,6.8,4,4,1,3,0,1,8,12.5,7,5,1,4,2,6,10,0,Matches
878,Wladimiro Falcone,ITA,GK,Lecce,Serie A,27,1995,38.0,2,0,2,0,0,2,2,100.0,0,0,0,0,2,4,21,3,Matches
879,Fali,ESP,"DF,MF",Cádiz,La Liga,28,1993,19.0,27,19,19,8,0,18,29,62.1,11,24,15,9,13,40,70,1,Matches
880,Fallou Fall,SEN,DF,Reims,Ligue 1,18,2004,0.4,0,0,0,0,0,0,1,0.0,1,3,3,0,0,0,4,0,Matches
881,Mamadou Fall,SEN,DF,Villarreal,La Liga,19,2002,0.3,0,0,0,0,0,0,0,0.0,0,1,0,1,0,0,1,0,Matches
882,Davide Faraoni,ITA,DF,Hellas Verona,Serie A,30,1991,16.5,34,24,19,13,2,16,41,39.0,25,30,11,19,15,49,37,0,Matches
883,Ansu Fati,ESP,FW,Barcelona,La Liga,19,2002,15.5,16,9,8,4,4,5,18,27.8,13,19,0,19,5,21,6,0,Matches
884,Khalil Fayad,FRA,MF,Montpellier,Ligue 1,18,2004,8.0,30,14,12,16,2,12,21,57.1,9,8,1,7,9,39,4,0,Matches
885,Cheikh Faye,SEN,FW,Montpellier,Ligue 1,23,1999,0.4,0,0,0,0,0,0,0,0.0,0,0,0,0,1,1,0,0,Matches
886,Federico Fazio,ARG,DF,Salernitana,Serie A,35,1987,11.9,15,12,8,7,0,4,11,36.4,7,9,4,5,28,43,61,0,Matches
887,Jacopo Fazzini,ITA,MF,Empoli,Serie A,19,2003,9.2,31,17,20,8,3,18,34,52.9,16,15,3,12,7,38,19,0,Matches
888,Zouhair Feddal,MAR,DF,Valladolid,La Liga,33,1989,4.2,4,2,1,3,0,3,4,75.0,1,9,9,0,5,9,27,0,Matches
889,Nabil Fekir,FRA,MF,Betis,La Liga,29,1993,10.7,11,5,3,3,5,2,9,22.2,7,6,2,4,1,12,0,0,Matches
890,Felipe,BRA,DF,Nott'ham Forest,Premier League,33,1989,15.8,42,23,29,13,0,24,41,58.5,17,34,13,21,36,78,90,0,Matches
891,Felipe,BRA,DF,Atlético Madrid,La Liga,33,1989,2.2,3,2,1,2,0,2,4,50.0,2,2,2,0,0,3,7,0,Matches
892,Luiz Felipe,ITA,DF,Betis,La Liga,25,1997,19.6,34,23,23,11,0,18,34,52.9,16,43,24,19,28,62,106,0,Matches
893,João Félix,POR,"FW,MF",Chelsea,Premier League,22,1999,10.5,14,7,5,6,3,4,12,33.3,8,3,0,3,1,15,1,1,Matches
894,João Félix,POR,"FW,MF",Atlético Madrid,La Liga,22,1999,7.2,10,7,2,3,5,1,6,16.7,5,1,0,1,3,13,2,0,Matches
895,Ohis Felix Uduokhai,GER,DF,Augsburg,Bundesliga,24,1997,16.1,30,20,14,13,3,15,29,51.7,14,27,14,13,29,59,61,1,Matches
896,Kiko Femenía,ESP,DF,Villarreal,La Liga,31,1991,12.6,18,9,14,3,1,13,18,72.2,5,15,6,9,20,38,22,0,Matches
897,Evan Ferguson,IRL,FW,Brighton,Premier League,17,2004,10.6,6,3,1,3,2,1,7,14.3,6,11,1,10,2,8,6,0,Matches
898,Lewis Ferguson,SCO,"MF,FW",Bologna,Serie A,22,1999,25.7,44,25,16,20,8,20,40,50.0,20,22,7,15,19,63,25,0,Matches
899,Bruno Fernandes,POR,"MF,FW",Manchester Utd,Premier League,27,1994,36.8,68,42,24,25,19,30,71,42.3,41,37,5,32,25,93,40,1,Matches
900,Edimilson Fernandes,SUI,DF,Mainz 05,Bundesliga,26,1996,27.1,35,25,26,5,4,18,34,52.9,16,37,16,21,54,89,87,2,Matches
901,Aitor Fernández,ESP,GK,Osasuna,La Liga,31,1991,21.0,1,1,1,0,0,0,1,0.0,1,0,0,0,2,3,17,0,Matches
902,Álex Fernández,ESP,"MF,FW",Cádiz,La Liga,29,1992,17.5,13,7,6,4,3,4,14,28.6,10,14,1,13,8,21,19,0,Matches
903,Álvaro Fernández,ESP,GK,Espanyol,La Liga,24,1998,11.0,0,0,0,0,0,0,0,0.0,0,0,0,0,0,0,7,2,Matches
904,Carlos Fernández,ESP,FW,Real Sociedad,La Liga,26,1996,7.0,6,4,1,3,2,1,15,6.7,14,1,0,1,1,7,4,0,Matches
905,Enzo Fernández,ARG,MF,Chelsea,Premier League,21,2001,17.2,45,27,25,17,3,21,56,37.5,35,32,2,30,16,61,12,1,Matches
906,Federico Fernández,ARG,DF,Elche,La Liga,33,1989,1.0,1,1,1,0,0,1,1,100.0,0,0,0,0,2,3,12,0,Matches
907,Joaquín Fernández,ESP,DF,Valladolid,La Liga,26,1996,24.0,35,28,20,11,4,19,30,63.3,11,31,22,9,27,62,98,1,Matches
908,Valery Fernández,ESP,"MF,DF",Girona,La Liga,22,1999,10.7,12,6,4,6,2,5,9,55.6,4,8,1,7,10,22,9,1,Matches
909,Fernando,ESP,GK,Almería,La Liga,32,1990,36.5,0,0,0,0,0,0,2,0.0,2,2,0,2,1,1,20,3,Matches
910,Fernando,BRA,"MF,DF",Sevilla,La Liga,35,1987,17.5,34,23,14,17,3,18,30,60.0,12,21,10,11,24,58,29,0,Matches
911,Alex Ferrari,ITA,DF,Sampdoria,Serie A,28,1994,9.6,9,5,7,2,0,4,8,50.0,4,21,10,11,19,28,25,0,Matches
912,Alex Ferrari,ITA,DF,Cremonese,Serie A,28,1994,11.2,40,23,32,7,1,28,42,66.7,14,19,4,15,25,65,45,1,Matches
913,Salvador Ferrer,ESP,DF,Spezia,Serie A,24,1998,1.5,4,2,2,2,0,1,3,33.3,2,3,1,2,1,5,4,0,Matches
914,Jordan Ferri,FRA,MF,Montpellier,Ligue 1,30,1992,30.4,55,35,32,19,4,30,89,33.7,59,22,6,16,26,81,21,0,Matches
915,Fidel,ESP,"MF,FW",Elche,La Liga,32,1989,19.0,15,10,8,5,2,4,38,10.5,34,9,0,9,5,20,8,0,Matches
916,Karol Fila,POL,DF,Strasbourg,Ligue 1,24,1998,0.5,0,0,0,0,0,0,0,0.0,0,0,0,0,1,1,1,0,Matches
917,Vincenzo Fiorillo,ITA,GK,Salernitana,Serie A,32,1990,1.0,0,0,0,0,0,0,0,0.0,0,0,0,0,0,0,0,0,Matches
918,Roberto Firmino,BRA,"FW,MF",Liverpool,Premier League,30,1991,13.5,17,12,2,12,3,4,21,19.0,17,16,1,15,7,24,2,0,Matches
919,Junior Firpo,ESP,DF,Leeds United,Premier League,25,1996,15.2,47,25,27,15,5,24,46,52.2,22,23,7,16,24,71,40,0,Matches
920,Kilian Fischer,GER,"DF,FW",Wolfsburg,Bundesliga,21,2000,5.6,9,6,3,4,2,6,11,54.5,5,6,0,6,5,14,18,0,Matches
921,Mark Flekken,NED,GK,Freiburg,Bundesliga,29,1993,34.0,0,0,0,0,0,0,1,0.0,1,1,0,1,0,0,9,5,Matches
922,Florian Flick,GER,MF,Schalke 04,Bundesliga,22,2000,5.7,12,3,7,5,0,4,14,28.6,10,9,3,6,4,16,18,0,Matches
923,Alexis Flips,FRA,"FW,MF",Reims,Ligue 1,22,2000,22.0,51,30,18,17,16,27,64,42.2,37,35,5,30,24,75,12,0,Matches
924,Alessandro Florenzi,ITA,DF,Milan,Serie A,31,1991,2.3,6,4,3,2,1,4,7,57.1,3,1,0,1,4,10,2,0,Matches
925,Phil Foden,ENG,FW,Manchester City,Premier League,22,2000,20.5,16,10,9,5,2,8,19,42.1,11,25,2,23,5,21,12,0,Matches
926,Seko Fofana,CIV,MF,Lens,Ligue 1,27,1995,34.1,28,13,8,18,2,15,39,38.5,24,17,4,13,19,47,14,0,Matches
927,Wesley Fofana,FRA,DF,Leicester City,Premier League,21,2000,2.0,4,2,1,2,1,1,3,33.3,2,1,1,0,9,13,5,0,Matches
928,Wesley Fofana,FRA,DF,Chelsea,Premier League,21,2000,13.1,30,18,19,7,4,13,26,50.0,13,17,10,7,20,50,33,2,Matches
929,Yahia Fofana,CIV,GK,Angers,Ligue 1,21,2000,11.0,0,0,0,0,0,0,0,0.0,0,0,0,0,1,1,4,1,Matches
930,Youssouf Fofana,FRA,MF,Monaco,Ligue 1,23,1999,34.3,81,41,31,42,8,38,74,51.4,36,50,6,44,56,137,32,1,Matches
931,Thomas Foket,BEL,DF,Reims,Ligue 1,27,1994,22.0,35,22,18,11,6,17,46,37.0,29,21,7,14,33,68,29,2,Matches
932,José Fonte,POR,DF,Lille,Ligue 1,38,1983,28.8,23,17,18,4,1,10,21,47.6,11,27,14,13,25,48,112,2,Matches
933,Pablo Fornals,ESP,"FW,MF",West Ham,Premier League,26,1996,16.7,30,15,9,12,9,13,34,38.2,21,16,2,14,14,44,9,0,Matches
934,Emil Forsberg,SWE,"MF,FW",RB Leipzig,Bundesliga,30,1991,16.5,16,11,1,8,7,6,20,30.0,14,25,2,23,3,19,7,0,Matches
935,Adam Forshaw,ENG,MF,Leeds United,Premier League,30,1991,5.3,12,9,5,7,0,7,17,41.2,10,9,1,8,4,16,2,0,Matches
936,Fraser Forster,ENG,GK,Tottenham,Premier League,34,1988,13.5,1,0,1,0,0,0,0,0.0,0,1,0,1,0,1,3,1,Matches
937,Philipp Förster,GER,MF,Bochum,Bundesliga,27,1995,14.5,31,19,11,15,5,12,40,30.0,28,22,0,22,6,37,6,0,Matches
938,Steven Fortes,CPV,DF,Lens,Ligue 1,30,1992,0.1,0,0,0,0,0,0,0,0.0,0,0,0,0,0,0,0,0,Matches
939,Timothy Fosu-Mensah,NED,DF,Leverkusen,Bundesliga,24,1998,2.1,7,5,3,3,1,4,4,100.0,0,2,0,2,0,7,1,0,Matches
940,Dimitri Foulquier,FRA,DF,Valencia,La Liga,29,1993,19.3,31,19,17,8,6,20,28,71.4,8,19,3,16,14,45,40,0,Matches
941,Juan Foyth,ARG,DF,Villarreal,La Liga,24,1998,21.8,73,48,49,22,2,41,57,71.9,16,32,11,21,20,93,68,0,Matches
942,Raphael Framberger,GER,"DF,FW",Augsburg,Bundesliga,26,1995,2.0,10,6,6,4,0,3,5,60.0,2,2,1,1,2,12,5,0,Matches
943,Tyrese Francois,AUS,FW,Fulham,Premier League,22,2000,0.0,0,0,0,0,0,0,0,0.0,0,0,0,0,0,0,1,0,Matches
944,Bartol Franjić,CRO,MF,Wolfsburg,Bundesliga,22,2000,2.5,4,2,2,2,0,0,2,0.0,2,4,1,3,5,9,4,0,Matches
945,Przemysław Frankowski,POL,"DF,MF",Lens,Ligue 1,27,1995,31.5,77,51,37,31,9,39,80,48.8,41,38,6,32,41,118,42,2,Matches
946,Ryan Fraser,SCO,FW,Newcastle Utd,Premier League,28,1994,3.5,2,2,0,0,2,2,5,40.0,3,3,1,2,0,2,3,0,Matches
947,Davide Frattesi,ITA,MF,Sassuolo,Serie A,22,1999,31.9,63,36,24,29,10,25,44,56.8,19,27,6,21,16,79,42,0,Matches
948,Oscar Fraulo,DEN,"FW,MF",M'Gladbach,Bundesliga,18,2003,0.1,0,0,0,0,0,0,0,0.0,0,0,0,0,0,0,0,0,Matches
949,Fred,BRA,MF,Manchester Utd,Premier League,29,1993,13.9,47,30,24,20,3,15,38,39.5,23,38,2,36,19,66,19,0,Matches
950,Ryan Fredericks,ENG,DF,Bournemouth,Premier League,29,1992,5.9,3,2,2,0,1,1,4,25.0,3,7,2,5,1,4,27,0,Matches
951,Iván Fresneda,ESP,DF,Valladolid,La Liga,17,2004,19.4,48,34,31,13,4,29,47,61.7,18,32,8,24,15,63,60,0,Matches
952,Remo Freuler,SUI,MF,Nott'ham Forest,Premier League,30,1992,24.0,43,23,23,15,5,19,43,44.2,24,36,9,27,29,72,45,0,Matches
953,Michael Frey,SUI,FW,Schalke 04,Bundesliga,28,1994,9.6,13,5,2,8,3,4,13,30.8,9,6,0,6,2,15,1,0,Matches
954,Marco Friedl,AUT,DF,Werder Bremen,Bundesliga,24,1998,28.8,62,46,40,22,0,41,68,60.3,27,46,17,29,58,120,127,1,Matches
955,Marvin Friedrich,GER,DF,M'Gladbach,Bundesliga,26,1995,13.9,17,11,13,3,1,10,13,76.9,3,14,6,8,11,28,52,0,Matches
956,Jeremie Frimpong,NED,"DF,MF",Leverkusen,Bundesliga,21,2000,30.1,53,27,22,26,5,23,44,52.3,21,24,3,21,16,69,40,0,Matches
957,Chris Führich,GER,"FW,MF",Stuttgart,Bundesliga,24,1998,20.9,36,14,15,14,7,24,44,54.5,20,29,2,27,7,43,13,0,Matches
958,Angelo Fulgini,FRA,"MF,FW",Lens,Ligue 1,25,1996,9.5,14,7,2,4,8,5,14,35.7,9,11,0,11,8,22,2,0,Matches
959,Angelo Fulgini,FRA,MF,Mainz 05,Bundesliga,25,1996,5.8,6,5,2,3,1,5,12,41.7,7,5,0,5,5,11,7,0,Matches
960,Niclas Füllkrug,GER,FW,Werder Bremen,Bundesliga,29,1993,27.5,9,4,0,6,3,3,13,23.1,10,13,4,9,1,10,24,0,Matches
961,Matteo Gabbia,ITA,DF,Milan,Serie A,22,1999,6.8,17,10,12,5,0,6,8,75.0,2,8,3,5,5,22,29,0,Matches
962,Manolo Gabbiadini,ITA,"FW,MF",Sampdoria,Serie A,30,1991,26.2,23,15,8,9,6,9,23,39.1,14,16,2,14,6,29,25,0,Matches
963,Gianluca Gaetano,ITA,MF,Napoli,Serie A,22,2000,0.8,5,3,1,3,1,0,0,0.0,0,1,0,1,1,6,0,0,Matches
964,Roberto Gagliardini,ITA,MF,Inter,Serie A,28,1994,8.7,16,6,9,6,1,10,21,47.6,11,14,5,9,4,20,15,0,Matches
965,Adolfo Gaich,ARG,FW,Hellas Verona,Serie A,23,1999,8.1,5,3,0,3,2,1,6,16.7,5,7,2,5,3,8,7,1,Matches
966,Cody Gakpo,NED,"FW,MF",Liverpool,Premier League,23,1999,16.2,26,15,4,13,9,13,38,34.2,25,13,1,12,4,30,2,0,Matches
967,Javi Galán,ESP,DF,Celta Vigo,La Liga,27,1994,35.1,104,72,60,40,4,48,98,49.0,50,54,5,49,41,145,63,1,Matches
968,Iñigo Ruiz de Galarreta,ESP,MF,Mallorca,La Liga,28,1993,27.2,54,38,27,23,4,20,52,38.5,32,26,9,17,30,84,19,0,Matches
969,Pablo Galdames Millán,CHI,MF,Cremonese,Serie A,25,1996,8.2,14,10,8,3,3,5,33,15.2,28,13,2,11,10,24,13,0,Matches
970,Conor Gallagher,ENG,MF,Chelsea,Premier League,22,2000,18.0,46,33,17,19,10,10,37,27.0,27,41,10,31,23,69,18,1,Matches
971,Antonino Gallo,ITA,DF,Lecce,Serie A,22,2000,27.6,56,36,35,12,9,38,57,66.7,19,37,6,31,13,69,71,0,Matches
972,Gauthier Gallon,FRA,GK,Troyes,Ligue 1,29,1993,29.6,2,2,2,0,0,2,4,50.0,2,0,0,0,2,4,17,0,Matches
973,Cristian Gamboa,CRC,DF,Bochum,Bundesliga,32,1989,16.4,42,24,27,14,1,21,31,67.7,10,20,7,13,16,58,34,1,Matches
974,Kévin Gameiro,FRA,FW,Strasbourg,Ligue 1,35,1987,23.3,20,10,6,10,4,8,28,28.6,20,10,1,9,9,29,0,0,Matches
975,Idrissa Gana Gueye,SEN,MF,Everton,Premier League,32,1989,28.6,97,57,49,35,13,31,60,51.7,29,50,12,38,56,153,34,3,Matches
976,Ignatius Ganago,CMR,"FW,MF",Nantes,Ligue 1,23,1999,16.9,9,7,2,3,4,4,7,57.1,3,13,1,12,2,11,12,0,Matches
977,Ignatius Ganago,CMR,FW,Lens,Ligue 1,23,1999,0.7,0,0,0,0,0,0,0,0.0,0,0,0,0,0,0,1,0,Matches
978,Silvère Ganvoula M'Boussy,CGO,"FW,MF",Bochum,Bundesliga,26,1996,2.7,2,2,0,1,1,0,0,0.0,0,0,0,0,0,2,3,0,Matches
979,Aleix García,ESP,MF,Girona,La Liga,25,1997,26.0,37,20,9,18,10,15,33,45.5,18,24,8,16,31,68,35,1,Matches
980,Álvaro García,ESP,"FW,MF",Rayo Vallecano,La Liga,29,1992,31.9,49,28,21,13,15,11,33,33.3,22,41,4,37,34,83,24,1,Matches
981,Borja García,ESP,"MF,FW",Girona,La Liga,31,1990,7.5,10,4,7,2,1,2,9,22.2,7,3,1,2,5,15,6,1,Matches
982,Carlos García,ESP,DF,Cádiz,La Liga,22,2000,0.3,0,0,0,0,0,0,0,0.0,0,0,0,0,0,0,2,0,Matches
983,Dani García,ESP,MF,Athletic Club,La Liga,32,1990,16.5,46,27,17,25,4,29,47,61.7,18,21,6,15,19,65,21,1,Matches
984,David García,ESP,DF,Osasuna,La Liga,28,1994,29.8,34,20,22,12,0,19,22,86.4,3,28,13,15,45,79,151,0,Matches
985,Eric García,ESP,"DF,MF",Barcelona,La Liga,21,2001,15.7,24,16,16,5,3,9,20,45.0,11,23,10,13,19,43,36,1,Matches
986,Fran Garcia,ESP,DF,Rayo Vallecano,La Liga,22,1999,37.9,84,54,53,23,8,55,96,57.3,41,49,8,41,44,128,66,0,Matches
987,Joan García,ESP,GK,Espanyol,La Liga,21,2001,1.0,0,0,0,0,0,0,0,0.0,0,0,0,0,0,0,0,0,Matches
988,Raúl García,ESP,"FW,MF",Athletic Club,La Liga,36,1986,10.7,12,8,3,4,5,5,15,33.3,10,13,1,12,6,18,9,0,Matches
989,Rubén García,ESP,"FW,MF",Osasuna,La Liga,29,1993,12.9,20,11,12,4,4,7,24,29.2,17,14,1,13,12,32,13,0,Matches
990,Unai García,ESP,DF,Osasuna,La Liga,30,1992,19.0,23,13,13,8,2,12,17,70.6,5,23,14,9,19,42,60,2,Matches
991,Alejandro Garnacho,ARG,"FW,MF",Manchester Utd,Premier League,18,2004,6.3,5,2,2,0,3,1,11,9.1,10,5,0,5,5,10,3,0,Matches
992,James Garner,ENG,"MF,DF",Everton,Premier League,21,2001,8.9,16,13,4,8,4,9,19,47.4,10,9,1,8,12,28,13,0,Matches
993,Felix Garreta,ESP,DF,Betis,La Liga,18,2004,1.0,1,0,0,1,0,0,0,0.0,0,1,1,0,1,2,4,0,Matches
994,Aleix Garrido,ESP,FW,Barcelona,La Liga,18,2004,0.1,2,1,1,0,1,1,1,100.0,0,1,0,1,0,2,0,0,Matches
995,Sékou Gassama,SEN,FW,Valladolid,La Liga,27,1995,0.4,0,0,0,0,0,0,0,0.0,0,0,0,0,0,0,0,0,Matches
996,Johan Gastien,FRA,MF,Clermont Foot,Ligue 1,34,1988,28.9,62,34,30,23,9,38,111,34.2,73,37,7,30,36,98,25,1,Matches
997,Federico Gatti,ITA,DF,Juventus,Serie A,24,1998,16.1,15,11,9,4,2,9,15,60.0,6,20,14,6,21,36,54,2,Matches
998,Gavi,ESP,"MF,FW",Barcelona,La Liga,17,2004,28.1,47,31,7,30,10,21,55,38.2,34,32,5,27,18,65,22,0,Matches
999,Paulo Gazzaniga,ARG,GK,Girona,La Liga,30,1992,28.0,0,0,0,0,0,0,1,0.0,1,0,0,0,1,1,9,5,Matches
1000,David de Gea,ESP,GK,Manchester Utd,Premier League,31,1990,38.0,0,0,0,0,0,0,1,0.0,1,0,0,0,1,1,15,3,Matches
1001,Dario Gebuhr,GER,DF,Eint Frankfurt,Bundesliga,19,2003,0.2,0,0,0,0,0,0,1,0.0,1,0,0,0,0,0,0,0,Matches
1002,Dennis Geiger,GER,MF,Hoffenheim,Bundesliga,24,1998,21.7,45,25,15,28,2,22,35,62.9,13,27,3,24,24,69,18,2,Matches
1003,Joe Gelhardt,ENG,FW,Leeds United,Premier League,20,2002,2.4,6,2,1,3,2,3,5,60.0,2,5,0,5,0,6,4,0,Matches
1004,Valentin Gendrey,FRA,DF,Lecce,Serie A,22,2000,34.5,88,57,54,25,9,40,71,56.3,31,45,4,41,37,125,89,0,Matches
1005,Denis Genreau,AUS,MF,Toulouse,Ligue 1,23,1999,7.3,35,13,16,12,7,13,31,41.9,18,16,1,15,8,43,9,0,Matches
1006,Yannick Gerhardt,GER,MF,Wolfsburg,Bundesliga,28,1994,20.7,29,15,10,11,8,12,30,40.0,18,26,5,21,7,36,24,0,Matches
1007,Valère Germain,FRA,"FW,MF",Montpellier,Ligue 1,32,1990,7.6,13,11,3,5,5,4,12,33.3,8,8,0,8,6,19,12,0,Matches
1008,Gerson,BRA,MF,Marseille,Ligue 1,25,1997,4.6,6,4,1,4,1,3,5,60.0,2,5,0,5,2,8,4,0,Matches
1009,Ismaël Gharbi,ESP,"MF,FW",Paris S-G,Ligue 1,18,2004,0.6,0,0,0,0,0,0,2,0.0,2,2,0,2,3,3,0,0,Matches
1010,Paolo Ghiglione,ITA,DF,Cremonese,Serie A,25,1997,7.9,16,11,10,3,3,10,23,43.5,13,9,4,5,4,20,12,0,Matches
1011,Saman Ghoddos,IRN,"MF,FW",Brentford,Premier League,28,1993,1.5,2,1,0,1,1,1,3,33.3,2,5,1,4,4,6,2,0,Matches
1012,Faouzi Ghoulam,ALG,DF,Angers,Ligue 1,31,1991,5.3,3,3,1,1,1,3,5,60.0,2,4,2,2,4,7,12,1,Matches
1013,Morgan Gibbs-White,ENG,"FW,MF",Wolves,Premier League,22,2000,2.0,3,1,3,0,0,2,3,66.7,1,2,0,2,1,4,3,0,Matches
1014,Morgan Gibbs-White,ENG,"MF,FW",Nott'ham Forest,Premier League,22,2000,33.0,26,14,7,7,12,11,32,34.4,21,23,4,19,14,40,15,0,Matches
1015,Niko Gießelmann,GER,DF,Union Berlin,Bundesliga,30,1991,14.5,21,11,9,9,3,13,31,41.9,18,17,5,12,9,30,28,0,Matches
1016,Samuel Gigot,FRA,DF,Marseille,Ligue 1,28,1993,20.9,46,24,22,21,3,12,15,80.0,3,24,7,17,45,91,85,1,Matches
1017,Rafał Gikiewicz,POL,GK,Augsburg,Bundesliga,34,1987,23.0,2,2,2,0,0,2,3,66.7,1,0,0,0,0,2,15,5,Matches
1018,Bryan Gil,ESP,"MF,FW",Tottenham,Premier League,21,2001,1.6,3,1,3,0,0,0,3,0.0,3,3,0,3,1,4,1,0,Matches
1019,Bryan Gil,ESP,"FW,DF",Sevilla,La Liga,21,2001,10.2,22,11,11,7,4,10,23,43.5,13,10,0,10,8,30,10,0,Matches
1020,David Gil,ESP,GK,Cádiz,La Liga,28,1994,4.0,0,0,0,0,0,0,0,0.0,0,0,0,0,0,0,3,0,Matches
1021,Óscar Gil,ESP,DF,Espanyol,La Liga,25,1997,28.4,63,37,38,16,9,32,61,52.5,29,51,18,33,31,94,55,1,Matches
1022,Mario Gila,ESP,DF,Lazio,Serie A,21,2000,1.0,3,1,3,0,0,0,1,0.0,1,0,0,0,3,6,3,0,Matches
1023,Billy Gilmour,SCO,MF,Brighton,Premier League,21,2001,5.6,5,2,2,2,1,2,8,25.0,6,5,2,3,6,11,5,0,Matches
1024,Álvaro Giménez,ESP,FW,Cádiz,La Liga,31,1991,0.2,0,0,0,0,0,0,1,0.0,1,0,0,0,0,0,0,0,Matches
1025,Gvidas Gineitis,LTU,MF,Torino,Serie A,18,2004,1.5,3,1,0,2,1,1,2,50.0,1,0,0,0,0,3,1,0,Matches
1026,Matthias Ginter,GER,DF,Freiburg,Bundesliga,28,1994,34.0,43,20,29,12,2,26,40,65.0,14,40,24,16,35,78,153,3,Matches
1027,Andrei Girotto,BRA,"DF,MF",Nantes,Ligue 1,30,1992,35.0,122,73,71,45,6,74,132,56.1,58,55,24,31,73,195,176,1,Matches
1028,Olivier Giroud,FRA,FW,Milan,Serie A,35,1986,23.8,8,5,2,4,2,2,10,20.0,8,11,3,8,3,11,23,0,Matches
1029,Serge Gnabry,GER,"FW,MF",Bayern Munich,Bundesliga,27,1995,21.6,35,23,11,14,10,17,43,39.5,26,24,1,23,11,46,5,1,Matches
1030,Degnand Gnonto,ITA,"FW,MF",Leeds United,Premier League,18,2003,15.0,27,17,7,15,5,10,30,33.3,20,24,1,23,5,32,7,0,Matches
1031,Ben Godfrey,ENG,DF,Everton,Premier League,24,1998,8.9,20,11,13,5,2,11,29,37.9,18,12,6,6,8,28,33,1,Matches
1032,Pierluigi Gollini,ITA,GK,Fiorentina,Serie A,27,1995,3.0,1,0,1,0,0,1,1,100.0,0,0,0,0,0,1,2,0,Matches
1033,Pierluigi Gollini,ITA,GK,Napoli,Serie A,27,1995,4.0,0,0,0,0,0,0,0,0.0,0,0,0,0,0,0,1,0,Matches
1034,Aleksandr Golovin,RUS,"MF,FW",Monaco,Ligue 1,26,1996,27.4,62,36,19,32,11,28,72,38.9,44,28,1,27,37,99,10,0,Matches
1035,André Gomes,POR,MF,Lille,Ligue 1,29,1993,18.1,37,19,12,17,8,19,52,36.5,33,20,5,15,9,46,16,1,Matches
1036,Angel Gomes,ENG,MF,Lille,Ligue 1,21,2000,31.3,41,19,12,21,8,18,49,36.7,31,22,2,20,13,54,11,1,Matches
1037,João Gomes,BRA,MF,Wolves,Premier League,21,2001,7.3,29,13,14,14,1,13,23,56.5,10,12,3,9,4,33,11,0,Matches
1038,Toti Gomes,POR,DF,Wolves,Premier League,23,1999,10.9,15,9,11,4,0,9,13,69.2,4,16,8,8,11,26,51,0,Matches
1039,Dani Gómez,ESP,"MF,FW",Espanyol,La Liga,24,1998,1.0,2,1,1,1,0,1,2,50.0,1,0,0,0,1,3,0,0,Matches
1040,Joe Gomez,ENG,DF,Liverpool,Premier League,25,1997,16.3,28,21,15,11,2,11,19,57.9,8,17,11,6,24,52,51,2,Matches
1041,Maxi Gómez,URU,FW,Valencia,La Liga,25,1996,1.2,0,0,0,0,0,0,0,0.0,0,0,0,0,0,0,2,0,Matches
1042,Moi Gómez,ESP,"MF,FW",Osasuna,La Liga,28,1994,27.3,26,17,9,14,3,15,32,46.9,17,15,3,12,10,36,5,1,Matches
1043,Papu Gómez,ARG,"FW,MF",Sevilla,La Liga,34,1988,11.8,6,4,3,3,0,2,10,20.0,8,8,1,7,4,10,5,0,Matches
1044,Sergi Gómez,ESP,DF,Espanyol,La Liga,30,1992,26.0,29,16,20,9,0,18,22,81.8,4,33,19,14,27,56,125,1,Matches
1045,Sergio Gómez,ESP,"DF,MF",Manchester City,Premier League,21,2000,3.9,9,4,6,1,2,5,8,62.5,3,5,3,2,2,11,9,1,Matches
1046,Antonio Gomis,ESP,GK,Atlético Madrid,La Liga,19,2003,0.1,0,0,0,0,0,0,0,0.0,0,0,0,0,0,0,0,0,Matches
1047,Maxime Gonalons,FRA,MF,Clermont Foot,Ligue 1,33,1989,16.1,52,32,25,21,6,25,53,47.2,28,21,1,20,20,72,7,1,Matches
1048,Diego González,ESP,DF,Elche,La Liga,27,1995,10.6,12,7,9,3,0,7,11,63.6,4,14,12,2,7,19,50,1,Matches
1049,Édgar González,ESP,DF,Betis,La Liga,25,1997,19.7,28,19,18,7,3,14,27,51.9,13,12,9,3,21,49,120,0,Matches
1050,Giovanni González,URU,DF,Mallorca,La Liga,27,1994,10.3,16,8,11,2,3,9,22,40.9,13,8,2,6,7,23,22,0,Matches
1051,Joan Gonzàlez,ESP,MF,Lecce,Serie A,20,2002,24.4,48,28,20,18,10,17,51,33.3,34,37,8,29,16,64,28,0,Matches
1052,Nicolás González,ARG,"FW,MF",Fiorentina,Serie A,24,1998,15.0,17,10,3,10,4,5,16,31.3,11,14,0,14,4,21,6,0,Matches
1053,Nicolás González,ESP,MF,Valencia,La Liga,20,2002,15.6,27,15,11,13,3,9,25,36.0,16,21,7,14,19,46,16,0,Matches
1054,Oumar Gonzalez,CMR,DF,Ajaccio,Ligue 1,24,1998,28.6,51,28,34,13,4,23,37,62.2,14,32,11,21,52,103,82,0,Matches
1055,Roberto González,ESP,"FW,MF",Betis,La Liga,21,2001,0.6,0,0,0,0,0,0,1,0.0,1,0,0,0,1,1,0,0,Matches
1056,Jacek Góralski,POL,MF,Bochum,Bundesliga,29,1992,1.6,6,3,3,3,0,4,6,66.7,2,4,0,4,3,9,5,0,Matches
1057,Anthony Gordon,ENG,"FW,MF",Newcastle Utd,Premier League,21,2001,5.4,14,12,5,7,2,9,20,45.0,11,9,1,8,2,16,1,1,Matches
1058,Anthony Gordon,ENG,FW,Everton,Premier League,21,2001,12.2,34,22,17,10,7,8,23,34.8,15,19,0,19,4,38,11,0,Matches
1059,Leon Goretzka,GER,MF,Bayern Munich,Bundesliga,27,1995,19.2,43,24,21,16,6,27,48,56.3,21,40,3,37,30,73,32,0,Matches
1060,Andoni Gorosabel,ESP,DF,Real Sociedad,La Liga,25,1996,19.0,41,25,23,9,9,26,43,60.5,17,21,2,19,17,58,23,0,Matches
1061,Robin Gosens,GER,DF,Inter,Serie A,28,1994,13.2,34,18,15,10,9,15,25,60.0,10,16,2,14,23,57,15,0,Matches
1062,Mario Götze,GER,MF,Eint Frankfurt,Bundesliga,30,1992,30.4,42,25,13,22,7,14,47,29.8,33,25,0,25,13,55,12,0,Matches
1063,Amine Gouiri,FRA,"FW,MF",Nice,Ligue 1,22,2000,2.5,1,1,1,0,0,0,1,0.0,1,1,0,1,0,1,3,0,Matches
1064,Amine Gouiri,FRA,"FW,MF",Rennes,Ligue 1,22,2000,28.0,42,25,14,16,12,14,33,42.4,19,21,0,21,12,54,10,0,Matches
1065,Jeffrey Gouweleeuw,NED,DF,Augsburg,Bundesliga,31,1991,31.1,42,27,19,17,6,24,49,49.0,25,41,23,18,50,92,141,2,Matches
1066,Jonathan Gradit,FRA,DF,Lens,Ligue 1,29,1992,31.4,62,40,30,25,7,31,53,58.5,22,40,26,14,38,100,83,0,Matches
1067,José Gragera,ESP,"MF,DF",Espanyol,La Liga,21,2000,5.1,19,9,11,6,2,6,11,54.5,5,10,4,6,7,26,18,0,Matches
1068,Alberto Grassi,ITA,MF,Empoli,Serie A,27,1995,13.3,26,21,13,13,0,15,24,62.5,9,23,12,11,27,53,45,0,Matches
1069,Ryan Gravenberch,NED,MF,Bayern Munich,Bundesliga,20,2002,6.4,17,8,4,10,3,7,13,53.8,6,9,1,8,9,26,10,0,Matches
1070,Andrew Gravillon,GLP,DF,Torino,Serie A,24,1998,3.5,3,3,0,3,0,0,0,0.0,0,4,2,2,9,12,16,0,Matches
1071,Andrew Gravillon,GLP,DF,Reims,Ligue 1,24,1998,11.5,16,8,9,6,1,8,13,61.5,5,18,9,9,21,37,36,0,Matches
1072,Demarai Gray,JAM,"FW,MF",Everton,Premier League,26,1996,27.9,33,24,9,14,10,17,31,54.8,14,23,3,20,13,46,18,0,Matches
1073,Adrian Grbić,AUT,"MF,FW",Lorient,Ligue 1,25,1996,0.3,0,0,0,0,0,0,1,0.0,1,3,0,3,0,0,0,0,Matches
1074,Ivo Grbić,CRO,GK,Atlético Madrid,La Liga,26,1996,10.2,0,0,0,0,0,0,0,0.0,0,0,0,0,0,0,9,1,Matches
1075,Jack Grealish,ENG,FW,Manchester City,Premier League,26,1995,22.8,25,16,10,12,3,13,22,59.1,9,17,3,14,7,32,9,0,Matches
1076,Sam Greenwood,ENG,"MF,FW",Leeds United,Premier League,20,2002,4.7,15,7,7,8,0,8,21,38.1,13,10,2,8,1,16,1,0,Matches
1077,Michael Gregoritsch,AUT,FW,Freiburg,Bundesliga,28,1994,23.9,19,12,6,9,4,3,21,14.3,18,23,4,19,5,24,10,0,Matches
1078,Dominik Greif,SVK,GK,Mallorca,La Liga,25,1997,1.0,0,0,0,0,0,0,0,0.0,0,0,0,0,0,0,0,0,Matches
1079,Leo Greiml,AUT,DF,Schalke 04,Bundesliga,21,2001,4.0,10,5,4,5,1,5,12,41.7,7,7,3,4,3,13,16,0,Matches
1080,Clément Grenier,FRA,MF,Mallorca,La Liga,31,1991,8.0,20,8,6,12,2,10,20,50.0,10,9,1,8,6,26,7,0,Matches
1081,Antoine Griezmann,FRA,"FW,MF",Atlético Madrid,La Liga,31,1991,31.8,49,34,15,23,11,20,66,30.3,46,34,3,31,24,73,31,0,Matches
1082,Vincenzo Grifo,ITA,"MF,FW",Freiburg,Bundesliga,29,1993,26.8,29,16,6,15,8,13,31,41.9,18,18,1,17,19,48,19,0,Matches
1083,Lennart Grill,GER,GK,Union Berlin,Bundesliga,23,1999,5.0,0,0,0,0,0,0,1,0.0,1,0,0,0,0,0,1,1,Matches
1084,Christian Groß,GER,MF,Werder Bremen,Bundesliga,33,1989,21.0,56,25,20,34,2,29,60,48.3,31,20,5,15,23,79,38,1,Matches
1085,Pascal Groß,GER,"MF,DF",Brighton,Premier League,31,1991,36.0,59,38,23,27,9,25,55,45.5,30,32,10,22,13,72,21,1,Matches
1086,Brajan Gruda,GER,MF,Mainz 05,Bundesliga,18,2004,0.0,0,0,0,0,0,0,0,0.0,0,0,0,0,0,0,0,0,Matches
1087,Ilia Gruev,BUL,MF,Werder Bremen,Bundesliga,22,2000,17.6,44,27,16,25,3,18,31,58.1,13,23,6,17,22,66,21,1,Matches
1088,Carlos Gruezo,ECU,MF,Augsburg,Bundesliga,27,1995,10.7,21,12,12,9,0,9,16,56.3,7,13,4,9,10,31,15,0,Matches
1089,Vicente Guaita,ESP,GK,Crystal Palace,Premier League,35,1987,27.0,0,0,0,0,0,0,0,0.0,0,0,0,0,0,0,9,1,Matches
1090,Andrés Guardado,MEX,MF,Betis,La Liga,35,1986,15.3,41,25,17,20,4,18,43,41.9,25,14,5,9,23,64,29,0,Matches
1091,Sergi Guardiola,ESP,FW,Valladolid,La Liga,31,1991,5.6,12,7,6,5,1,2,4,50.0,2,6,0,6,2,14,7,0,Matches
1092,Sergi Guardiola,ESP,FW,Cádiz,La Liga,31,1991,12.9,9,7,0,6,3,3,12,25.0,9,5,0,5,3,12,7,0,Matches
1093,Nemanja Gudelj,SRB,"DF,MF",Sevilla,La Liga,30,1991,30.9,43,33,22,18,3,20,33,60.6,13,39,29,10,34,77,102,1,Matches
1094,Gabriel Gudmundsson,SWE,"DF,FW",Lille,Ligue 1,23,1999,9.3,19,11,7,10,2,12,22,54.5,10,11,2,9,10,29,20,0,Matches
1095,Gonçalo Guedes,POR,"FW,MF",Wolves,Premier League,25,1996,7.9,8,6,4,3,1,5,8,62.5,3,4,0,4,1,9,2,0,Matches
1096,Axel Gueguin,FRA,"FW,MF",Montpellier,Ligue 1,17,2005,0.3,0,0,0,0,0,0,0,0.0,0,1,0,1,0,0,0,0,Matches
1097,Marc Guéhi,ENG,DF,Crystal Palace,Premier League,22,2000,37.0,52,27,39,11,2,26,42,61.9,16,45,24,21,45,97,134,3,Matches
1098,Mattéo Guendouzi,FRA,MF,Marseille,Ligue 1,23,1999,23.4,39,18,9,21,9,14,38,36.8,24,12,5,7,21,60,18,0,Matches
1099,Javier Guerra,ESP,MF,Valencia,La Liga,19,2003,6.7,16,13,7,4,5,9,20,45.0,11,8,1,7,11,27,9,0,Matches
1100,Raphaël Guerreiro,POR,"DF,MF",Dortmund,Bundesliga,28,1993,25.4,36,20,13,15,8,21,34,61.8,13,21,2,19,36,72,23,0,Matches
1101,Axel Guessand,FRA,DF,Udinese,Serie A,17,2004,0.9,2,1,2,0,0,1,2,50.0,1,1,0,1,2,4,3,0,Matches
1102,Evann Guessand,FRA,"FW,MF",Nantes,Ligue 1,21,2001,14.0,24,16,8,13,3,6,12,50.0,6,17,1,16,9,33,6,0,Matches
1103,Ander Guevara,ESP,MF,Real Sociedad,La Liga,25,1997,2.5,5,2,2,2,1,1,4,25.0,3,6,1,5,2,7,3,0,Matches
1104,Pape Gueye,SEN,MF,Sevilla,La Liga,23,1999,13.0,37,22,13,21,3,16,33,48.5,17,21,5,16,22,59,10,0,Matches
1105,Pape Gueye,SEN,"MF,DF",Marseille,Ligue 1,23,1999,5.5,18,7,10,7,1,7,15,46.7,8,9,2,7,9,27,2,0,Matches
1106,Josuha Guilavogui,FRA,"DF,MF",Wolfsburg,Bundesliga,31,1990,13.1,18,11,7,10,1,6,17,35.3,11,19,13,6,23,41,52,0,Matches
1107,Frederic Guilbert,FRA,DF,Strasbourg,Ligue 1,27,1994,16.2,47,29,18,23,6,25,43,58.1,18,24,3,21,43,90,33,1,Matches
1108,Bruno Guimarães,BRA,MF,Newcastle Utd,Premier League,24,1997,30.3,78,40,27,46,5,38,65,58.5,27,28,4,24,36,114,22,1,Matches
1109,Serhou Guirassy,GUI,MF,Rennes,Ligue 1,26,1996,0.3,0,0,0,0,0,0,0,0.0,0,0,0,0,0,0,0,0,Matches
1110,Serhou Guirassy,GUI,FW,Stuttgart,Bundesliga,26,1996,18.3,4,1,2,2,0,1,2,50.0,1,7,2,5,0,4,14,0,Matches
1111,Rafik Guitane,FRA,FW,Reims,Ligue 1,23,1999,0.0,0,0,0,0,0,0,0,0.0,0,0,0,0,0,0,1,0,Matches
1112,Péter Gulácsi,HUN,GK,RB Leipzig,Bundesliga,32,1990,6.0,0,0,0,0,0,0,0,0.0,0,0,0,0,0,0,2,0,Matches
1113,Manuel Gulde,GER,DF,Freiburg,Bundesliga,31,1991,7.1,14,8,10,4,0,2,4,50.0,2,5,1,4,19,33,25,0,Matches
1114,Gerard Gumbau,ESP,MF,Elche,La Liga,27,1994,30.4,44,25,17,23,4,18,51,35.3,33,32,8,24,28,72,40,0,Matches
1115,Robert Gumny,POL,DF,Augsburg,Bundesliga,24,1998,22.4,34,24,13,15,6,11,27,40.7,16,21,7,14,26,60,62,1,Matches
1116,İlkay Gündoğan,GER,MF,Manchester City,Premier League,31,1990,26.1,30,18,7,13,10,12,33,36.4,21,18,3,15,20,50,13,0,Matches
1117,Christian Günter,GER,"DF,MF",Freiburg,Bundesliga,29,1993,30.5,29,21,18,9,2,13,43,30.2,30,22,4,18,16,45,41,0,Matches
1118,Koray Günter,GER,DF,Hellas Verona,Serie A,27,1994,11.1,10,6,1,8,1,4,7,57.1,3,24,15,9,30,40,46,0,Matches
1119,Koray Günter,GER,DF,Sampdoria,Serie A,27,1994,8.6,10,8,6,4,0,6,9,66.7,3,10,5,5,11,21,46,0,Matches
1120,Gorka Guruzeta,ESP,FW,Athletic Club,La Liga,25,1996,15.8,24,20,6,12,6,11,24,45.8,13,23,2,21,4,28,8,0,Matches
1121,Malo Gusto,FRA,DF,Lyon,Ligue 1,19,2003,17.7,42,26,23,11,8,21,43,48.8,22,22,5,17,28,70,23,1,Matches
1122,Raúl Guti,ESP,MF,Elche,La Liga,25,1996,12.4,18,12,8,9,1,8,18,44.4,10,10,3,7,8,26,6,0,Matches
1123,Miguel Gutiérrez,ESP,DF,Girona,La Liga,21,2001,26.6,41,23,23,13,5,23,37,62.2,14,23,5,18,18,59,42,1,Matches
1124,Joško Gvardiol,CRO,DF,RB Leipzig,Bundesliga,20,2002,24.1,23,17,15,8,0,9,22,40.9,13,34,17,17,34,57,76,1,Matches
1125,Darko Gyabi,ENG,FW,Leeds United,Premier League,18,2004,0.1,2,2,1,1,0,0,0,0.0,0,2,0,2,0,2,0,0,Matches
1126,Emmanuel Gyasi,GHA,"FW,DF",Spezia,Serie A,28,1994,31.2,24,15,11,10,3,9,36,25.0,27,24,6,18,8,32,26,0,Matches
1127,Norbert Gyömbér,SVK,DF,Salernitana,Serie A,30,1992,19.3,32,23,25,6,1,16,24,66.7,8,33,22,11,35,67,92,0,Matches
1128,Christian Gytkjær,DEN,"FW,MF",Monza,Serie A,32,1990,6.2,6,2,1,4,1,2,5,40.0,3,6,1,5,0,6,2,0,Matches
1129,Erling Haaland,NOR,FW,Manchester City,Premier League,22,2000,30.8,3,2,0,2,1,1,5,20.0,4,12,4,8,3,6,14,0,Matches
1130,Nicolas Haas,SUI,MF,Empoli,Serie A,26,1996,12.8,27,13,16,6,5,12,24,50.0,12,16,4,12,8,35,27,0,Matches
1131,Janik Haberer,GER,MF,Union Berlin,Bundesliga,28,1994,24.3,29,17,8,18,3,17,48,35.4,31,35,2,33,14,43,25,0,Matches
1132,Alexander Hack,GER,DF,Mainz 05,Bundesliga,28,1993,12.6,30,18,21,9,0,19,33,57.6,14,18,5,13,24,54,45,1,Matches
1133,Munir El Haddadi,MAR,"MF,FW",Getafe,La Liga,26,1995,12.8,12,7,3,7,2,2,10,20.0,8,23,2,21,9,21,7,0,Matches
1134,Jaouen Hadjam,ALG,DF,Nantes,Ligue 1,19,2003,8.9,27,21,13,9,5,16,25,64.0,9,10,3,7,12,39,12,0,Matches
1135,Dennis Hadzikadunic,BIH,DF,Mallorca,La Liga,24,1998,6.8,9,6,4,5,0,4,4,100.0,0,5,4,1,3,12,27,0,Matches
1136,André Hahn,GER,"FW,MF",Augsburg,Bundesliga,31,1990,4.3,9,5,4,4,1,8,12,66.7,4,9,2,7,4,13,14,0,Matches
1137,Amadou Haidara,MLI,MF,RB Leipzig,Bundesliga,24,1998,15.9,25,11,15,10,0,13,34,38.2,21,26,6,20,26,51,20,0,Matches
1138,Massadio Haïdara,MLI,"DF,MF",Lens,Ligue 1,29,1992,18.6,24,16,9,9,6,12,24,50.0,12,26,9,17,36,60,39,1,Matches
1139,Achraf Hakimi,MAR,"DF,MF",Paris S-G,Ligue 1,23,1998,22.8,54,34,19,20,15,31,59,52.5,28,34,2,32,16,70,19,0,Matches
1140,Lewis Hall,ENG,DF,Chelsea,Premier League,17,2004,7.3,23,12,19,4,0,15,22,68.2,7,8,0,8,11,34,11,1,Matches
1141,Sébastien Haller,CIV,FW,Dortmund,Bundesliga,28,1994,13.6,5,4,2,1,2,0,4,0.0,4,8,0,8,1,6,10,0,Matches
1142,Marcel Halstenberg,GER,DF,RB Leipzig,Bundesliga,30,1991,17.3,40,21,20,15,5,23,41,56.1,18,22,1,21,21,61,29,0,Matches
1143,Mathis Hamdi,FRA,DF,Troyes,Ligue 1,18,2003,0.8,0,0,0,0,0,0,1,0.0,1,0,0,0,1,1,1,0,Matches
1144,Ben Hamed Touré,CIV,FW,Ajaccio,Ligue 1,18,2003,2.3,4,4,2,2,0,1,5,20.0,4,2,0,2,1,5,4,0,Matches
1145,Romain Hamouma,FRA,"FW,MF",Ajaccio,Ligue 1,35,1987,12.0,8,3,3,3,2,3,6,50.0,3,8,0,8,2,10,2,0,Matches
1146,Saïd Hamulic,BIH,FW,Toulouse,Ligue 1,21,2000,1.2,0,0,0,0,0,0,0,0.0,0,0,0,0,0,0,0,0,Matches
1147,Andreas Hanche-Olsen,NOR,DF,Mainz 05,Bundesliga,25,1997,16.6,35,23,24,7,4,22,39,56.4,17,16,8,8,33,68,77,2,Matches
1148,Samir Handanović,SVN,GK,Inter,Serie A,38,1984,13.7,0,0,0,0,0,0,0,0.0,0,0,0,0,0,0,5,0,Matches
1149,Genki Haraguchi,JPN,MF,Stuttgart,Bundesliga,31,1991,8.3,16,7,7,7,2,4,16,25.0,12,13,2,11,8,24,6,0,Matches
1150,Genki Haraguchi,JPN,MF,Union Berlin,Bundesliga,31,1991,5.5,12,8,1,10,1,3,9,33.3,6,7,1,6,3,15,9,0,Matches
1151,Amine Harit,MAR,"MF,FW",Marseille,Ligue 1,25,1997,5.7,6,4,0,3,3,3,8,37.5,5,4,1,3,4,10,6,0,Matches
1152,Luke Harris,WAL,"MF,FW",Fulham,Premier League,17,2005,0.1,0,0,0,0,0,0,0,0.0,0,0,0,0,0,0,0,0,Matches
1153,Jack Harrison,ENG,"FW,MF",Leeds United,Premier League,25,1996,30.1,41,17,5,15,21,12,52,23.1,40,47,2,45,22,63,25,0,Matches
1154,Abdou Harroui,NED,MF,Sassuolo,Serie A,24,1998,7.2,17,6,6,7,4,2,7,28.6,5,6,1,5,2,19,10,0,Matches
1155,Makoto Hasebe,JPN,DF,Eint Frankfurt,Bundesliga,38,1984,14.5,18,12,16,2,0,7,22,31.8,15,22,9,13,17,35,45,0,Matches
1156,Haissem Hassan,FRA,"FW,MF",Villarreal,La Liga,20,2002,0.6,0,0,0,0,0,0,2,0.0,2,0,0,0,1,1,0,0,Matches
1157,Hans Hateboer,NED,DF,Atalanta,Serie A,28,1994,15.5,21,13,11,8,2,11,27,40.7,16,23,4,19,12,33,25,0,Matches
1158,Kai Havertz,GER,"FW,MF",Chelsea,Premier League,23,1999,28.5,34,16,4,20,10,10,30,33.3,20,28,0,28,7,41,41,0,Matches
1159,Eden Hazard,BEL,FW,Real Madrid,La Liga,31,1991,2.2,0,0,0,0,0,0,2,0.0,2,1,0,1,1,1,0,0,Matches
1160,Thorgan Hazard,BEL,"FW,DF",Dortmund,Bundesliga,29,1993,5.2,17,6,5,11,1,12,17,70.6,5,6,0,6,5,22,5,0,Matches
1161,Rhys Healey,WAL,FW,Toulouse,Ligue 1,27,1994,0.7,0,0,0,0,0,0,0,0.0,0,0,0,0,0,0,0,0,Matches
1162,Jan Paul van Hecke,NED,DF,Brighton,Premier League,22,2000,3.3,8,6,3,4,1,5,5,100.0,0,8,5,3,6,14,9,0,Matches
1163,Jonas Hector,GER,DF,Köln,Bundesliga,32,1990,31.4,112,66,59,43,10,66,113,58.4,47,61,9,52,39,151,74,1,Matches
1164,Hwang Hee-chan,KOR,"FW,MF",Wolves,Premier League,26,1996,12.6,20,9,7,8,5,6,19,31.6,13,18,2,16,5,25,5,0,Matches
1165,Gauthier Hein,FRA,"MF,FW",Auxerre,Ligue 1,25,1996,20.8,27,20,13,11,3,18,48,37.5,30,10,0,10,6,33,10,0,Matches
1166,Dominique Heintz,GER,DF,Bochum,Bundesliga,28,1993,8.8,13,9,5,7,1,6,17,35.3,11,11,7,4,12,25,34,0,Matches
1167,Dean Henderson,ENG,GK,Nott'ham Forest,Premier League,25,1997,18.0,0,0,0,0,0,0,0,0.0,0,0,0,0,0,0,12,1,Matches
1168,Jordan Henderson,ENG,MF,Liverpool,Premier League,32,1990,23.0,32,23,10,18,4,15,36,41.7,21,21,3,18,21,53,16,1,Matches
1169,Liam Henderson,SCO,MF,Empoli,Serie A,26,1996,11.2,13,10,6,5,2,4,21,19.0,17,10,2,8,10,23,10,0,Matches
1170,Jack Hendry,SCO,DF,Cremonese,Serie A,27,1995,2.4,0,0,0,0,0,0,1,0.0,1,2,1,1,1,1,7,0,Matches
1171,Wayne Hennessey,WAL,GK,Nott'ham Forest,Premier League,35,1987,3.0,1,0,1,0,0,1,1,100.0,0,0,0,0,0,1,2,0,Matches
1172,Benjamin Henrichs,GER,"DF,MF",RB Leipzig,Bundesliga,25,1997,24.3,73,46,41,29,3,43,66,65.2,23,48,4,44,35,108,46,0,Matches
1173,Henrique,BRA,"DF,FW",Lyon,Ligue 1,28,1994,4.0,9,4,3,2,4,6,13,46.2,7,3,1,2,5,14,8,0,Matches
1174,Luiz Henrique,BRA,FW,Betis,La Liga,21,2001,20.1,48,34,27,15,6,20,44,45.5,24,22,0,22,14,62,17,0,Matches
1175,Matheus Henrique,BRA,MF,Sassuolo,Serie A,24,1997,21.6,26,12,9,11,6,12,24,50.0,12,15,4,11,12,38,10,0,Matches
1176,Rico Henry,ENG,DF,Brentford,Premier League,25,1997,36.0,57,31,20,28,9,22,41,53.7,19,29,8,21,30,87,84,1,Matches
1177,Thomas Henry,FRA,FW,Hellas Verona,Serie A,27,1994,11.4,5,3,1,1,3,1,5,20.0,4,6,2,4,0,5,14,0,Matches
1178,Christophe Hérelle,MTQ,DF,Brest,Ligue 1,29,1992,11.8,10,4,7,2,1,4,13,30.8,9,16,11,5,20,30,48,0,Matches
1179,Mario Hermoso,ESP,DF,Atlético Madrid,La Liga,27,1995,23.4,22,15,14,6,2,9,30,30.0,21,19,9,10,19,41,85,1,Matches
1180,Javi Hernández,ESP,DF,Girona,La Liga,24,1998,12.4,21,12,12,7,2,13,21,61.9,8,10,5,5,7,28,38,0,Matches
1181,Aridane Hernández,ESP,DF,Osasuna,La Liga,33,1989,19.9,21,15,17,4,0,12,25,48.0,13,34,21,13,28,49,96,1,Matches
1182,Lucas Hernández,FRA,DF,Bayern Munich,Bundesliga,26,1996,5.3,6,4,3,3,0,5,6,83.3,1,2,1,1,5,11,7,0,Matches
1183,Luis Hernández,ESP,DF,Cádiz,La Liga,33,1989,35.0,33,21,25,7,1,22,36,61.1,14,31,24,7,31,64,145,0,Matches
1184,Mario Hernández,ESP,DF,Rayo Vallecano,La Liga,23,1999,1.1,3,2,2,1,0,3,7,42.9,4,2,0,2,2,5,0,0,Matches
1185,Theo Hernández,FRA,DF,Milan,Serie A,24,1997,30.8,43,24,27,15,1,22,38,57.9,16,34,7,27,21,64,35,1,Matches
1186,Jorge Herrando,ESP,DF,Osasuna,La Liga,21,2001,0.3,0,0,0,0,0,0,0,0.0,0,1,0,1,0,0,3,0,Matches
1187,Ander Herrera,ESP,MF,Athletic Club,La Liga,32,1989,7.7,18,10,8,7,3,6,18,33.3,12,12,3,9,11,29,12,0,Matches
1188,Sergio Herrera,ESP,GK,Osasuna,La Liga,29,1993,17.0,2,0,2,0,0,2,2,100.0,0,1,0,1,1,3,6,2,Matches
1189,Yangel Herrera,VEN,"MF,FW",Girona,La Liga,24,1998,10.7,26,9,9,14,3,6,15,40.0,9,14,1,13,4,30,12,0,Matches
1190,Patrick Herrmann,GER,"FW,MF",M'Gladbach,Bundesliga,31,1991,1.8,6,2,4,1,1,2,4,50.0,2,2,0,2,2,8,1,0,Matches
1191,Son Heung-min,KOR,"MF,FW",Tottenham,Premier League,30,1992,32.1,24,12,7,8,9,9,30,30.0,21,23,2,21,13,37,6,0,Matches
1192,Aaron Hickey,SCO,DF,Brentford,Premier League,20,2002,21.3,38,26,27,11,0,18,32,56.3,14,18,7,11,17,55,32,1,Matches
1193,Isak Hien,SWE,DF,Hellas Verona,Serie A,23,1999,29.0,73,36,54,19,0,38,61,62.3,23,40,17,23,31,104,92,1,Matches
1194,Omar El Hilali,MAR,"DF,MF",Espanyol,La Liga,18,2003,1.0,3,2,3,0,0,1,2,50.0,1,1,0,1,1,4,6,0,Matches
1195,Piero Hincapié,ECU,DF,Leverkusen,Bundesliga,20,2002,27.3,51,34,28,20,3,25,38,65.8,13,41,20,21,31,82,83,1,Matches
1196,Jack Hinshelwood,ENG,FW,Brighton,Premier League,17,2005,0.0,1,0,1,0,0,0,0,0.0,0,0,0,0,0,1,0,0,Matches
1197,Morten Hjulmand,DEN,MF,Lecce,Serie A,23,1999,32.9,90,52,49,40,1,37,67,55.2,30,43,11,32,72,162,54,0,Matches
1198,Adam Hložek,CZE,"FW,MF",Leverkusen,Bundesliga,20,2002,14.3,9,4,4,3,2,3,9,33.3,6,9,2,7,6,15,9,0,Matches
1199,Joseph Hodge,IRL,MF,Wolves,Premier League,19,2002,1.9,5,2,1,3,1,3,4,75.0,1,5,0,5,0,5,2,1,Matches
1200,Nicolas Höfler,GER,MF,Freiburg,Bundesliga,32,1990,31.3,66,35,28,35,3,27,61,44.3,34,40,13,27,58,124,49,0,Matches
1201,Jonas Hofmann,GER,"FW,MF",M'Gladbach,Bundesliga,30,1992,29.8,31,16,17,8,6,15,52,28.8,37,36,2,34,16,47,21,0,Matches
1202,Philipp Hofmann,GER,FW,Bochum,Bundesliga,29,1993,29.2,18,11,0,13,5,5,12,41.7,7,20,8,12,6,24,48,0,Matches
1203,Rob Holding,ENG,DF,Arsenal,Premier League,26,1995,6.3,8,5,4,4,0,3,6,50.0,3,6,5,1,3,11,27,1,Matches
1204,Lucas Höler,GER,"FW,MF",Freiburg,Bundesliga,28,1994,16.7,19,14,5,7,7,6,22,27.3,16,22,5,17,10,29,17,0,Matches
1205,Mason Holgate,ENG,DF,Everton,Premier League,25,1996,5.6,11,7,8,3,0,3,11,27.3,8,7,3,4,7,18,28,0,Matches
1206,Emil Holm,SWE,DF,Spezia,Serie A,22,2000,15.5,26,15,13,8,5,16,31,51.6,15,21,6,15,9,35,41,0,Matches
1207,Noah Holm,NOR,"FW,MF",Reims,Ligue 1,21,2001,2.2,6,4,2,2,2,2,5,40.0,3,0,0,0,0,6,5,0,Matches
1208,Gerrit Holtmann,PHI,"FW,MF",Bochum,Bundesliga,27,1995,10.5,14,7,6,7,1,12,21,57.1,9,15,1,14,2,16,4,0,Matches
1209,Martin Hongla,CMR,MF,Hellas Verona,Serie A,24,1998,5.8,8,5,4,4,0,5,5,100.0,0,7,1,6,6,14,9,0,Matches
1210,Martin Hongla,CMR,"DF,MF",Valladolid,La Liga,24,1998,14.5,18,13,13,5,0,11,21,52.4,10,15,12,3,8,26,46,1,Matches
1211,Franck Honorat,FRA,"FW,MF",Brest,Ligue 1,25,1996,28.2,41,29,20,8,13,19,34,55.9,15,22,2,20,21,62,18,0,Matches
1212,Jannes Horn,GER,"DF,FW",Bochum,Bundesliga,25,1997,0.7,2,1,1,1,0,1,1,100.0,0,1,0,1,3,5,2,0,Matches
1213,Cédric Hountondji,BEN,DF,Angers,Ligue 1,28,1994,34.4,50,36,31,17,2,19,29,65.5,10,44,22,22,59,109,132,1,Matches
1214,Ilyes Housni,FRA,FW,Paris S-G,Ligue 1,17,2005,0.1,1,1,1,0,0,1,1,100.0,0,0,0,0,0,1,0,0,Matches
1215,Lukáš Hrádecký,FIN,GK,Leverkusen,Bundesliga,32,1989,33.0,0,0,0,0,0,0,0,0.0,0,0,0,0,0,0,3,3,Matches
1216,Petko Hristov,BUL,DF,Spezia,Serie A,23,1999,4.1,6,4,2,4,0,5,8,62.5,3,4,2,2,4,10,12,0,Matches
1217,Ajdin Hrustic,AUS,MF,Hellas Verona,Serie A,26,1996,2.5,2,1,1,1,0,1,2,50.0,1,2,0,2,0,2,2,1,Matches
1218,Timo Hübers,GER,DF,Köln,Bundesliga,26,1996,28.4,43,28,35,8,0,24,52,46.2,28,27,13,14,58,101,153,0,Matches
1219,Callum Hudson-Odoi,ENG,"FW,MF",Leverkusen,Bundesliga,21,2000,6.7,5,3,4,0,1,1,1,100.0,0,0,0,0,2,7,4,0,Matches
1220,Will Hughes,ENG,MF,Crystal Palace,Premier League,27,1995,9.4,29,16,11,16,2,11,20,55.0,9,16,7,9,16,45,9,0,Matches
1221,Mats Hummels,GER,DF,Dortmund,Bundesliga,33,1988,22.4,62,34,38,22,2,32,55,58.2,23,30,16,14,33,95,100,1,Matches
1222,Adrien Hunou,FRA,"MF,FW",Angers,Ligue 1,28,1994,24.8,39,20,17,16,6,16,45,35.6,29,35,0,35,7,46,7,0,Matches
1223,Denis Huseinbasic,GER,"MF,FW",Köln,Bundesliga,21,2001,8.8,23,9,8,11,4,10,25,40.0,15,16,2,14,4,27,5,0,Matches
1224,Omari Hutchinson,ENG,FW,Chelsea,Premier League,18,2003,0.3,0,0,0,0,0,0,0,0.0,0,0,0,0,1,1,0,0,Matches
1225,Elseid Hysaj,ALB,DF,Lazio,Serie A,28,1994,22.2,39,23,24,11,4,23,41,56.1,18,31,7,24,20,59,42,0,Matches
1226,Pierre Højbjerg,DEN,MF,Tottenham,Premier League,26,1995,34.8,56,30,28,22,6,26,67,38.8,41,46,17,29,49,105,64,1,Matches
1227,Rasmus Højlund,DEN,FW,Atalanta,Serie A,19,2003,20.4,4,3,0,2,2,1,6,16.7,5,9,1,8,1,5,5,0,Matches
1228,Iago,BRA,"DF,MF",Augsburg,Bundesliga,25,1997,17.8,34,16,20,10,4,11,29,37.9,18,18,5,13,17,51,53,0,Matches
1229,Pablo Ibáñez,ESP,MF,Osasuna,La Liga,23,1998,11.8,29,13,7,17,5,12,35,34.3,23,19,2,17,8,37,24,0,Matches
1230,Roger Ibanez,BRA,DF,Roma,Serie A,23,1998,31.1,67,33,38,26,3,32,48,66.7,16,30,11,19,66,133,95,2,Matches
1231,Arijon Ibrahimović,GER,MF,Bayern Munich,Bundesliga,16,2005,0.2,1,1,1,0,0,0,0,0.0,0,0,0,0,0,1,0,0,Matches
1232,Zlatan Ibrahimović,SWE,FW,Milan,Serie A,40,1981,1.6,0,0,0,0,0,0,0,0.0,0,1,1,0,0,0,2,0,Matches
1233,Mounaim El Idrissy,FRA,FW,Ajaccio,Ligue 1,23,1999,27.7,32,19,5,20,7,10,36,27.8,26,22,0,22,13,45,20,0,Matches
1234,Antonio Iervolino,ITA,MF,Salernitana,Serie A,19,2003,0.1,0,0,0,0,0,0,1,0.0,1,0,0,0,0,0,0,0,Matches
1235,Iglesias,ESP,"DF,MF",Getafe,La Liga,24,1998,23.8,61,35,40,18,3,33,65,50.8,32,40,5,35,21,82,91,1,Matches
1236,Borja Iglesias,ESP,FW,Betis,La Liga,29,1993,26.3,8,4,3,3,2,2,13,15.4,11,9,1,8,1,9,17,0,Matches
1237,Igor,BRA,DF,Fiorentina,Serie A,24,1998,22.9,43,29,21,18,4,20,27,74.1,7,33,14,19,25,68,56,2,Matches
1238,Kelechi Iheanacho,NGA,"FW,MF",Leicester City,Premier League,25,1996,12.5,7,2,0,3,4,3,10,30.0,7,9,1,8,0,7,8,0,Matches
1239,Jonathan Ikone,FRA,FW,Fiorentina,Serie A,24,1998,22.3,16,8,5,6,5,5,14,35.7,9,18,1,17,4,20,3,0,Matches
1240,Ivan Ilić,SRB,MF,Hellas Verona,Serie A,21,2001,9.5,16,10,9,7,0,6,11,54.5,5,10,1,9,8,24,14,0,Matches
1241,Ivan Ilić,SRB,MF,Torino,Serie A,21,2001,13.1,18,7,6,11,1,10,20,50.0,10,12,3,9,5,23,10,0,Matches
1242,Rareş Ilie,ROU,"MF,FW",Nice,Ligue 1,19,2003,1.6,3,3,0,1,2,2,4,50.0,2,2,0,2,1,4,1,0,Matches
1243,Samuel Iling-Junior,ENG,"DF,FW",Juventus,Serie A,18,2003,3.5,7,2,3,1,3,4,9,44.4,5,5,1,4,2,9,6,0,Matches
1244,Emirhan İlkhan,TUR,MF,Torino,Serie A,18,2004,1.0,1,1,0,1,0,1,1,100.0,0,3,1,2,2,3,2,0,Matches
1245,Emirhan İlkhan,TUR,MF,Sampdoria,Serie A,18,2004,1.3,6,3,2,2,2,2,3,66.7,1,5,1,4,0,6,3,0,Matches
1246,Asier Illarramendi,ESP,MF,Real Sociedad,La Liga,32,1990,12.0,36,18,10,22,4,16,44,36.4,28,27,8,19,18,54,20,0,Matches
1247,Ciro Immobile,ITA,FW,Lazio,Serie A,32,1990,24.7,11,5,4,4,3,6,9,66.7,3,10,2,8,1,12,14,0,Matches
1248,Danny Ings,ENG,FW,West Ham,Premier League,30,1992,8.6,9,8,0,4,5,5,14,35.7,9,8,2,6,3,12,5,0,Matches
1249,Danny Ings,ENG,FW,Aston Villa,Premier League,30,1992,9.2,10,5,1,6,3,1,6,16.7,5,12,1,11,1,11,11,0,Matches
1250,Marcus Ingvartsen,DEN,"FW,MF",Mainz 05,Bundesliga,26,1996,14.6,4,1,0,2,2,1,10,10.0,9,9,1,8,4,8,10,0,Matches
1251,Bonke Innocent,NGA,MF,Lorient,Ligue 1,26,1996,13.1,28,17,13,14,1,11,36,30.6,25,22,5,17,26,54,31,0,Matches
1252,Alexander Isak,SWE,FW,Newcastle Utd,Premier League,22,1999,16.9,18,8,4,7,7,10,28,35.7,18,21,2,19,4,22,8,0,Matches
1253,Alexander Isak,SWE,FW,Real Sociedad,La Liga,22,1999,1.7,1,1,0,0,1,0,0,0.0,0,0,0,0,0,1,2,0,Matches
1254,Isco,ESP,"MF,FW",Sevilla,La Liga,30,1992,8.9,15,9,6,5,4,8,14,57.1,6,3,0,3,10,25,3,0,Matches
1255,Ismaily,BRA,DF,Lille,Ligue 1,32,1990,19.8,41,18,16,16,9,17,32,53.1,15,25,5,20,21,62,39,0,Matches
1256,Ardian Ismajli,ALB,DF,Empoli,Serie A,25,1996,23.3,40,32,25,15,0,18,24,75.0,6,47,31,16,27,67,120,0,Matches
1257,Ko Itakura,JPN,DF,M'Gladbach,Bundesliga,25,1997,22.0,29,17,18,7,4,16,30,53.3,14,41,25,16,27,56,95,0,Matches
1258,Hiroki Ito,JPN,DF,Stuttgart,Bundesliga,23,1999,28.5,40,29,24,14,2,18,35,51.4,17,38,17,21,40,80,94,0,Matches
1259,Junya Ito,JPN,FW,Reims,Ligue 1,29,1993,32.4,40,20,14,15,11,13,53,24.5,40,29,1,28,8,48,4,1,Matches
1260,Diego Iturralde,ESP,DF,Sevilla,La Liga,19,2003,0.5,1,0,1,0,0,0,2,0.0,2,0,0,0,0,1,1,0,Matches
1261,Andreas Ivan,ROU,MF,Schalke 04,Bundesliga,27,1995,0.5,0,0,0,0,0,0,1,0.0,1,0,0,0,0,0,1,0,Matches
1262,Mihailo Ivanović,SRB,FW,Sampdoria,Serie A,17,2004,0.0,0,0,0,0,0,0,0,0.0,0,0,0,0,0,0,0,0,Matches
1263,Daniel Iversen,DEN,GK,Leicester City,Premier League,25,1997,12.0,0,0,0,0,0,0,0,0.0,0,0,0,0,0,0,6,1,Matches
1264,Alex Iwobi,NGA,"MF,FW",Everton,Premier League,26,1996,37.5,69,37,37,28,4,33,65,50.8,32,41,2,39,25,94,29,0,Matches
1265,Armando Izzo,ITA,DF,Monza,Serie A,30,1992,27.4,73,50,44,27,2,29,45,64.4,16,29,17,12,50,123,87,1,Matches
1266,Nicolas Jackson,SEN,FW,Villarreal,La Liga,21,2001,17.8,14,11,2,10,2,2,8,25.0,6,18,2,16,2,16,4,0,Matches
1267,Lee Jae-sung,KOR,MF,Mainz 05,Bundesliga,29,1992,21.0,38,17,9,21,8,16,36,44.4,20,29,5,24,17,55,21,0,Matches
1268,Paul Jaeckel,GER,DF,Union Berlin,Bundesliga,24,1998,13.3,24,18,11,11,2,17,35,48.6,18,11,5,6,19,43,44,1,Matches
1269,Mato Jajalo,BIH,MF,Udinese,Serie A,34,1988,0.7,0,0,0,0,0,0,1,0.0,1,0,0,0,0,0,2,0,Matches
1270,Kristijan Jakić,CRO,"DF,MF",Eint Frankfurt,Bundesliga,25,1997,16.2,33,21,19,12,2,22,41,53.7,19,32,10,22,14,47,49,1,Matches
1271,Ismail Jakobs,SEN,"DF,FW",Monaco,Ligue 1,22,1999,12.4,11,5,7,3,1,5,12,41.7,7,9,1,8,9,20,18,0,Matches
1272,Marin Jakoliš,CRO,FW,Angers,Ligue 1,25,1996,0.3,1,1,0,0,1,0,0,0.0,0,0,0,0,0,1,0,0,Matches
1273,Daniel James,WAL,FW,Leeds United,Premier League,24,1997,2.2,6,2,1,3,2,3,6,50.0,3,4,0,4,2,8,2,0,Matches
1274,Daniel James,WAL,FW,Fulham,Premier League,24,1997,6.9,9,5,4,4,1,4,8,50.0,4,5,1,4,1,10,5,0,Matches
1275,Reece James,ENG,"DF,MF",Chelsea,Premier League,22,1999,13.8,31,20,10,18,3,15,19,78.9,4,17,2,15,12,43,23,0,Matches
1276,Vitaly Janelt,GER,"MF,DF",Brentford,Premier League,24,1998,24.5,54,27,20,24,10,21,49,42.9,28,29,9,20,29,83,26,0,Matches
1277,Saidy Janko,GAM,DF,Bochum,Bundesliga,26,1995,12.6,23,15,13,8,2,12,20,60.0,8,24,10,14,11,34,33,1,Matches
1278,Pontus Jansson,SWE,DF,Brentford,Premier League,31,1991,8.0,5,3,4,1,0,3,5,60.0,2,13,9,4,9,14,38,0,Matches
1279,Tony Jantschke,GER,"DF,MF",M'Gladbach,Bundesliga,32,1990,1.1,2,1,1,1,0,1,1,100.0,0,5,3,2,0,2,5,0,Matches
1280,Adnan Januzaj,BEL,FW,Sevilla,La Liga,27,1995,0.5,0,0,0,0,0,0,1,0.0,1,0,0,0,1,1,0,0,Matches
1281,Léo Jardim,BRA,GK,Lille,Ligue 1,27,1995,6.0,0,0,0,0,0,0,1,0.0,1,0,0,0,0,0,0,1,Matches
1282,Luis Javier Suárez,COL,FW,Almería,La Liga,24,1997,16.6,17,11,5,6,6,6,26,23.1,20,13,3,10,3,20,10,0,Matches
1283,Luis Javier Suárez,COL,FW,Marseille,Ligue 1,24,1997,3.3,4,1,1,2,1,1,4,25.0,3,1,0,1,3,7,6,0,Matches
1284,Dany Jean,HAI,"DF,MF",Strasbourg,Ligue 1,19,2002,0.1,0,0,0,0,0,0,1,0.0,1,1,0,1,0,0,0,0,Matches
1285,Julian Jeanvier,GUI,DF,Auxerre,Ligue 1,30,1992,19.6,32,17,24,8,0,13,22,59.1,9,24,17,7,27,59,96,1,Matches
1286,Jefferson,BRA,FW,Lyon,Ligue 1,22,1999,5.0,17,4,4,9,4,6,15,40.0,9,6,0,6,1,18,0,0,Matches
1287,Fredrik Jensen,FIN,"FW,MF",Augsburg,Bundesliga,24,1997,10.3,15,10,8,3,4,5,10,50.0,5,12,5,7,4,19,12,0,Matches
1288,Mathias Jensen,DEN,MF,Brentford,Premier League,26,1996,31.1,70,35,28,30,12,34,97,35.1,63,54,5,49,32,102,24,1,Matches
1289,Moritz Jenz,GER,DF,Schalke 04,Bundesliga,23,1999,10.5,14,11,8,5,1,5,8,62.5,3,16,10,6,8,22,53,1,Matches
1290,Jesé,ESP,FW,Sampdoria,Serie A,29,1993,2.3,2,0,0,2,0,0,1,0.0,1,3,1,2,1,3,2,0,Matches
1291,Gabriel Jesus,BRA,FW,Arsenal,Premier League,25,1997,22.9,33,25,16,8,9,15,31,48.4,16,27,3,24,11,44,15,1,Matches
1292,Juan Jesus,BRA,DF,Napoli,Serie A,31,1991,10.4,16,11,9,6,1,9,12,75.0,3,18,11,7,10,26,29,0,Matches
1293,Raúl Jiménez,MEX,FW,Wolves,Premier League,31,1991,9.4,9,6,3,5,1,3,6,50.0,3,9,0,9,0,9,8,0,Matches
1294,Joaquín,ESP,"MF,FW",Betis,La Liga,41,1981,5.5,3,3,2,1,0,1,3,33.3,2,7,2,5,4,7,5,0,Matches
1295,Joelinton,BRA,"MF,FW",Newcastle Utd,Premier League,25,1996,29.6,70,49,36,26,8,26,62,41.9,36,52,7,45,48,118,39,0,Matches
1296,Þórir Jóhann Helgason,ISL,MF,Lecce,Serie A,21,2000,2.5,2,2,1,0,1,2,3,66.7,1,3,1,2,3,5,3,0,Matches
1297,Ben Johnson,ENG,DF,West Ham,Premier League,22,2000,9.6,20,14,12,4,4,12,18,66.7,6,12,4,8,9,29,28,1,Matches
1298,Brennan Johnson,WAL,"FW,MF",Nott'ham Forest,Premier League,21,2001,32.6,34,20,18,8,8,8,28,28.6,20,30,1,29,5,39,7,1,Matches
1299,Sam Johnstone,ENG,GK,Crystal Palace,Premier League,29,1993,9.0,0,0,0,0,0,0,0,0.0,0,0,0,0,0,0,5,0,Matches
1300,Paul Joly,FRA,DF,Auxerre,Ligue 1,22,2000,9.6,33,21,21,10,2,19,35,54.3,16,13,2,11,24,57,29,2,Matches
1301,Curtis Jones,ENG,MF,Liverpool,Premier League,21,2001,11.5,34,17,8,12,14,18,31,58.1,13,12,2,10,3,37,9,0,Matches
1302,Frenkie de Jong,NED,MF,Barcelona,La Liga,25,1997,28.2,46,26,16,21,9,17,41,41.5,24,11,1,10,35,81,22,1,Matches
1303,Joan Jordán,ESP,MF,Sevilla,La Liga,28,1994,17.7,32,17,13,17,2,16,38,42.1,22,14,7,7,16,48,14,2,Matches
1304,Jorginho,ITA,MF,Arsenal,Premier League,30,1991,9.5,18,13,6,10,2,5,24,20.8,19,7,2,5,9,27,8,0,Matches
1305,Jorginho,ITA,MF,Chelsea,Premier League,30,1991,14.2,42,23,22,14,6,22,46,47.8,24,18,3,15,21,63,7,0,Matches
1306,Josan,ESP,"DF,MF",Elche,La Liga,32,1989,12.0,25,20,20,5,0,14,27,51.9,13,8,0,8,7,32,15,1,Matches
1307,Willian José,BRA,FW,Betis,La Liga,30,1991,8.1,9,6,6,3,0,4,9,44.4,5,4,0,4,1,10,15,0,Matches
1308,Joselu,ESP,FW,Espanyol,La Liga,32,1990,33.2,13,11,3,4,6,4,17,23.5,13,25,4,21,8,21,43,0,Matches
1309,Mateo Joseph,ENG,"FW,MF",Leeds United,Premier League,18,2003,0.3,0,0,0,0,0,0,0,0.0,0,1,0,1,0,0,1,0,Matches
1310,Diogo Jota,POR,FW,Liverpool,Premier League,25,1996,12.6,23,15,8,8,7,12,37,32.4,25,5,0,5,3,26,11,0,Matches
1311,Stevan Jovetić,MNE,"FW,MF",Hertha BSC,Bundesliga,32,1989,9.9,3,2,2,1,0,1,11,9.1,10,2,1,1,2,5,10,0,Matches
1312,Luka Jović,SRB,"FW,MF",Fiorentina,Serie A,24,1997,17.0,6,3,1,4,1,2,8,25.0,6,7,2,5,2,8,10,0,Matches
1313,Juanmi,ESP,FW,Betis,La Liga,29,1993,10.3,14,10,4,7,3,7,31,22.6,24,10,0,10,4,18,4,0,Matches
1314,Juanpe,ESP,DF,Girona,La Liga,31,1991,15.8,19,11,10,9,0,11,17,64.7,6,12,9,3,10,29,60,1,Matches
1315,Jubal,BRA,DF,Auxerre,Ligue 1,28,1993,35.7,41,26,29,11,1,19,38,50.0,19,57,34,23,53,94,193,0,Matches
1316,Christopher Jullien,FRA,DF,Montpellier,Ligue 1,29,1993,29.9,46,28,29,14,3,28,51,54.9,23,35,18,17,43,89,114,1,Matches
1317,Anthony Jung,GER,"DF,FW",Werder Bremen,Bundesliga,30,1991,29.1,46,27,19,20,7,31,58,53.4,27,30,6,24,22,68,63,0,Matches
1318,Eli Junior Kroupi,FRA,"FW,MF",Lorient,Ligue 1,16,2006,0.1,0,0,0,0,0,0,1,0.0,1,0,0,0,1,1,0,0,Matches
1319,Lago Junior,CIV,"FW,MF",Mallorca,La Liga,31,1990,0.6,1,0,0,1,0,1,1,100.0,0,0,0,0,0,1,0,0,Matches
1320,Hamed Junior Traorè,CIV,"FW,MF",Bournemouth,Premier League,22,2000,4.7,17,11,5,9,3,6,18,33.3,12,9,0,9,2,19,1,0,Matches
1321,Hamed Junior Traorè,CIV,"MF,FW",Sassuolo,Serie A,22,2000,6.6,11,6,4,6,1,4,11,36.4,7,4,0,4,2,13,0,1,Matches
1322,Vinicius Júnior,BRA,FW,Real Madrid,La Liga,22,2000,31.4,30,21,10,12,8,14,39,35.9,25,24,1,23,6,36,1,0,Matches
1323,Josip Juranović,CRO,DF,Union Berlin,Bundesliga,26,1995,10.4,9,7,5,2,2,7,18,38.9,11,9,3,6,6,15,22,1,Matches
1324,James Justin,ENG,DF,Leicester City,Premier League,24,1998,13.9,20,18,7,12,1,9,14,64.3,5,24,6,18,15,35,47,0,Matches
1325,Filip Jørgensen,DEN,GK,Villarreal,La Liga,20,2002,2.0,0,0,0,0,0,0,1,0.0,1,0,0,0,0,0,0,0,Matches
1326,Mathias Jørgensen,DEN,DF,Brentford,Premier League,32,1990,12.3,17,8,9,8,0,9,21,42.9,12,19,12,7,16,33,39,1,Matches
1327,Ozan Kabak,TUR,DF,Hoffenheim,Bundesliga,22,2000,26.5,51,34,27,21,3,17,30,56.7,13,35,23,12,45,96,83,0,Matches
1328,Issa Kaboré,BFA,DF,Marseille,Ligue 1,21,2001,11.4,33,19,10,18,5,21,32,65.6,11,11,1,10,12,45,21,1,Matches
1329,Abdoul Kader Bamba,FRA,"FW,MF",Nantes,Ligue 1,28,1994,0.9,0,0,0,0,0,0,2,0.0,2,3,1,2,0,0,1,0,Matches
1330,Pavel Kadeřábek,CZE,DF,Hoffenheim,Bundesliga,30,1992,18.5,26,20,10,9,7,15,23,65.2,8,12,2,10,14,40,37,1,Matches
1331,Tino Kadewere,ZIM,"FW,MF",Mallorca,La Liga,26,1996,6.0,6,3,3,3,0,4,9,44.4,5,6,2,4,2,8,1,0,Matches
1332,Kaiky,BRA,DF,Almería,La Liga,18,2004,6.5,5,5,5,0,0,3,7,42.9,4,18,10,8,11,16,28,0,Matches
1333,Florian Kainz,AUT,"MF,FW",Köln,Bundesliga,29,1992,26.0,21,10,7,12,2,8,26,30.8,18,27,6,21,32,53,30,1,Matches
1334,Gaël Kakuta,COD,FW,Lens,Ligue 1,31,1991,0.2,0,0,0,0,0,0,0,0.0,0,0,0,0,0,0,1,0,Matches
1335,Sasa Kalajdzic,AUT,FW,Wolves,Premier League,25,1997,0.5,0,0,0,0,0,0,0,0.0,0,0,0,0,1,1,0,0,Matches
1336,Sasa Kalajdzic,AUT,FW,Stuttgart,Bundesliga,25,1997,2.6,3,2,0,1,2,1,3,33.3,2,1,0,1,0,3,0,0,Matches
1337,Arnaud Kalimuendo,FRA,FW,Rennes,Ligue 1,20,2002,20.5,15,8,3,6,6,5,20,25.0,15,15,2,13,2,17,9,0,Matches
1338,Yayah Kallon,SLE,"MF,FW",Hellas Verona,Serie A,21,2001,9.6,14,10,5,4,5,7,12,58.3,5,10,0,10,8,22,5,0,Matches
1339,Gedeon Kalulu,COD,DF,Lorient,Ligue 1,24,1997,27.1,64,34,43,14,7,30,48,62.5,18,32,3,29,28,92,79,2,Matches
1340,Pierre Kalulu,FRA,DF,Milan,Serie A,22,2000,28.3,57,39,33,21,3,28,42,66.7,14,41,17,24,41,98,56,1,Matches
1341,Justin-Noël Kalumba,FRA,DF,Angers,Ligue 1,17,2004,6.1,9,5,5,2,2,5,16,31.3,11,4,1,3,4,13,5,0,Matches
1342,Daichi Kamada,JPN,MF,Eint Frankfurt,Bundesliga,25,1996,25.2,51,31,10,37,4,31,57,54.4,26,31,2,29,16,67,17,1,Matches
1343,Waren Kamanzi,NOR,DF,Toulouse,Ligue 1,21,2000,7.4,16,9,9,5,2,13,19,68.4,6,8,2,6,8,24,9,0,Matches
1344,Bingourou Kamara,SEN,GK,Montpellier,Ligue 1,25,1996,4.5,0,0,0,0,0,0,0,0.0,0,0,0,0,0,0,2,0,Matches
1345,Boubacar Kamara,FRA,MF,Aston Villa,Premier League,22,1999,19.7,58,25,25,23,10,27,56,48.2,29,38,12,26,19,77,24,2,Matches
1346,Jakub Kamiński,POL,"FW,DF",Wolfsburg,Bundesliga,20,2002,22.9,36,25,15,13,8,20,40,50.0,20,37,2,35,8,44,15,0,Matches
1347,Marcin Kamiński,POL,DF,Schalke 04,Bundesliga,30,1992,7.0,6,4,4,0,2,2,4,50.0,2,8,7,1,9,15,28,0,Matches
1348,Kevin Kampl,SVN,MF,RB Leipzig,Bundesliga,31,1990,15.2,21,11,6,14,1,6,27,22.2,21,26,9,17,22,43,11,0,Matches
1349,Nordine Kandil,FRA,"MF,FW",Strasbourg,Ligue 1,20,2001,1.1,3,2,1,2,0,0,3,0.0,3,2,0,2,1,4,1,0,Matches
1350,Harry Kane,ENG,FW,Tottenham,Premier League,29,1993,37.8,15,12,1,6,8,7,21,33.3,14,27,7,20,2,17,18,0,Matches
1351,Lee Kang-in,KOR,"MF,FW",Mallorca,La Liga,21,2001,31.4,42,24,10,22,10,18,61,29.5,43,25,2,23,11,53,7,0,Matches
1352,Wilfried Kanga,CIV,FW,Hertha BSC,Bundesliga,24,1998,15.7,5,4,2,1,2,2,4,50.0,2,14,3,11,2,7,13,0,Matches
1353,N'Golo Kanté,FRA,MF,Chelsea,Premier League,31,1991,5.8,16,10,4,10,2,4,8,50.0,4,11,0,11,6,22,2,0,Matches
1354,Kenan Karaman,TUR,FW,Schalke 04,Bundesliga,28,1994,10.8,11,8,3,5,3,3,12,25.0,9,9,1,8,3,14,9,0,Matches
1355,Yann Karamoh,FRA,"MF,FW",Torino,Serie A,24,1998,8.0,5,2,3,2,0,1,5,20.0,4,5,0,5,0,5,2,1,Matches
1356,Atakan Karazor,GER,MF,Stuttgart,Bundesliga,25,1996,21.8,49,30,18,25,6,24,47,51.1,23,39,11,28,31,80,44,0,Matches
1357,Ayman Kari,FRA,"MF,DF",Lorient,Ligue 1,17,2004,1.1,0,0,0,0,0,0,0,0.0,0,4,0,4,3,3,0,0,Matches
1358,Jon Karrikaburu,ESP,FW,Real Sociedad,La Liga,19,2002,1.0,1,0,0,1,0,0,0,0.0,0,2,0,2,0,1,0,0,Matches
1359,Rick Karsdorp,NED,DF,Roma,Serie A,27,1995,7.9,21,13,11,7,3,13,22,59.1,9,0,0,0,7,28,15,1,Matches
1360,Denso Kasius,NED,DF,Bologna,Serie A,19,2002,3.8,12,6,7,4,1,8,10,80.0,2,6,3,3,3,15,6,0,Matches
1361,Thomas Kastanaras,GRE,"FW,DF",Stuttgart,Bundesliga,19,2003,0.8,0,0,0,0,0,0,0,0.0,0,1,0,1,0,0,0,0,Matches
1362,Grigoris Kastanos,CYP,"MF,DF",Salernitana,Serie A,24,1998,14.3,39,23,18,19,2,16,40,40.0,24,20,6,14,8,47,8,0,Matches
1363,Silas Katompa,COD,"FW,MF",Stuttgart,Bundesliga,23,1998,22.1,25,17,5,14,6,6,20,30.0,14,17,2,15,8,33,1,0,Matches
1364,Moise Kean,ITA,FW,Juventus,Serie A,22,2000,11.1,8,6,2,5,1,3,7,42.9,4,4,0,4,5,13,2,0,Matches
1365,Michael Keane,ENG,DF,Everton,Premier League,29,1993,10.9,7,4,5,2,0,5,8,62.5,3,12,7,5,14,21,55,1,Matches
1366,Neeskens Kebano,COD,FW,Fulham,Premier League,30,1992,8.5,17,9,8,6,3,9,17,52.9,8,14,0,14,1,18,8,0,Matches
1367,Kévin Keben Biakolo,CMR,DF,Toulouse,Ligue 1,18,2004,4.0,3,2,2,0,1,0,4,0.0,4,1,0,1,5,8,9,0,Matches
1368,Thilo Kehrer,GER,DF,West Ham,Premier League,25,1996,24.8,43,24,25,14,4,21,44,47.7,23,16,6,10,34,77,76,1,Matches
1369,Check Keita,FRA,DF,Reims,Ligue 1,19,2003,7.6,12,9,9,3,0,4,9,44.4,5,6,5,1,5,17,24,1,Matches
1370,Naby Keïta,GUI,MF,Liverpool,Premier League,27,1995,3.3,5,4,2,3,0,1,4,25.0,3,1,0,1,2,7,3,0,Matches
1371,Yannik Keitel,GER,MF,Freiburg,Bundesliga,22,2000,7.6,11,7,4,6,1,3,5,60.0,2,6,3,3,13,24,8,0,Matches
1372,Caoimhín Kelleher,IRL,GK,Liverpool,Premier League,23,1998,1.0,0,0,0,0,0,0,0,0.0,0,0,0,0,0,0,0,0,Matches
1373,Lloyd Kelly,ENG,DF,Bournemouth,Premier League,23,1998,22.7,33,18,23,9,1,13,19,68.4,6,26,15,11,26,59,101,1,Matches
1374,Marc-Oliver Kempf,GER,DF,Hertha BSC,Bundesliga,27,1995,30.1,44,27,29,14,1,16,22,72.7,6,42,32,10,51,95,143,0,Matches
1375,Kenedy,BRA,"FW,DF",Valladolid,La Liga,26,1996,3.1,6,2,3,3,0,2,4,50.0,2,2,0,2,1,7,0,0,Matches
1376,Jonjoe Kenny,ENG,DF,Hertha BSC,Bundesliga,25,1997,24.9,46,34,27,16,3,24,42,57.1,18,38,9,29,46,92,74,0,Matches
1377,Franck Kessié,CIV,MF,Barcelona,La Liga,25,1996,11.0,15,9,6,6,3,8,18,44.4,10,10,2,8,12,27,11,2,Matches
1378,Saîf-Eddine Khaoui,TUN,MF,Clermont Foot,Ligue 1,27,1995,22.5,47,28,14,25,8,15,47,31.9,32,17,2,15,33,80,8,0,Matches
1379,Wahbi Khazri,TUN,"FW,MF",Montpellier,Ligue 1,31,1991,18.2,26,13,13,7,6,6,25,24.0,19,17,1,16,9,35,20,0,Matches
1380,Rani Khedira,GER,MF,Union Berlin,Bundesliga,28,1994,32.0,60,33,21,32,7,25,50,50.0,25,33,10,23,40,100,33,0,Matches
1381,Anthony Khelifa,FRA,DF,Ajaccio,Ligue 1,16,2005,0.1,0,0,0,0,0,0,0,0.0,0,0,0,0,0,0,0,0,Matches
1382,Kiké,ESP,FW,Osasuna,La Liga,32,1989,11.3,6,3,0,4,2,2,5,40.0,3,6,1,5,1,7,13,0,Matches
1383,Luca Kilian,GER,DF,Köln,Bundesliga,22,1999,12.5,22,16,14,7,1,12,21,57.1,9,16,8,8,11,33,48,0,Matches
1384,Max Kilman,ENG,DF,Wolves,Premier League,25,1997,36.7,36,20,26,9,1,16,30,53.3,14,70,42,28,19,55,164,1,Matches
1385,Joshua Kimmich,GER,MF,Bayern Munich,Bundesliga,27,1995,31.2,78,49,24,46,8,38,72,52.8,34,36,7,29,41,119,39,2,Matches
1386,Presnel Kimpembe,FRA,DF,Paris S-G,Ligue 1,26,1995,8.1,17,8,9,6,2,9,13,69.2,4,12,7,5,13,30,9,1,Matches
1387,Jakub Kiwior,POL,DF,Arsenal,Premier League,22,2000,4.7,7,5,6,1,0,5,8,62.5,3,5,3,2,6,13,10,0,Matches
1388,Jakub Kiwior,POL,DF,Spezia,Serie A,22,2000,16.0,22,17,15,7,0,6,24,25.0,18,26,18,8,24,46,71,1,Matches
1389,Simon Kjær,DEN,DF,Milan,Serie A,33,1989,11.2,15,8,9,6,0,7,11,63.6,4,14,11,3,9,24,35,1,Matches
1390,Pascal Klemens,GER,DF,Hertha BSC,Bundesliga,17,2005,1.0,0,0,0,0,0,0,1,0.0,1,1,0,1,1,1,3,0,Matches
1391,Mateusz Klich,POL,"MF,FW",Leeds United,Premier League,32,1990,3.1,12,8,3,4,5,7,13,53.8,6,4,0,4,0,12,1,0,Matches
1392,Lukas Klostermann,GER,DF,RB Leipzig,Bundesliga,26,1996,10.1,16,8,7,9,0,8,15,53.3,7,6,3,3,13,29,31,0,Matches
1393,Justin Kluivert,NED,"FW,MF",Valencia,La Liga,23,1999,16.1,17,14,7,4,6,6,12,50.0,6,4,0,4,7,24,4,0,Matches
1394,Ansgar Knauff,GER,DF,Eint Frankfurt,Bundesliga,20,2002,14.3,36,25,22,11,3,15,34,44.1,19,19,1,18,15,51,26,0,Matches
1395,Robin Knoche,GER,DF,Union Berlin,Bundesliga,30,1992,31.9,45,29,29,12,4,24,47,51.1,23,35,18,17,38,83,140,0,Matches
1396,Gregor Kobel,SUI,GK,Dortmund,Bundesliga,24,1997,27.0,0,0,0,0,0,0,1,0.0,1,1,0,1,0,0,7,2,Matches
1397,Robin Koch,GER,DF,Leeds United,Premier League,26,1996,35.3,53,30,32,16,5,24,56,42.9,32,44,21,23,43,96,152,1,Matches
1398,Samuel Koeberlé,FRA,MF,Reims,Ligue 1,17,2004,0.0,0,0,0,0,0,0,0,0.0,0,0,0,0,0,0,0,0,Matches
1399,Rudy Kohon,FRA,DF,Troyes,Ligue 1,18,2004,0.7,4,3,4,0,0,2,2,100.0,0,1,0,1,1,5,2,0,Matches
1400,Dominik Kohr,GER,MF,Mainz 05,Bundesliga,28,1994,25.5,59,33,23,31,5,29,61,47.5,32,46,9,37,34,93,26,1,Matches
1401,Koke,ESP,MF,Atlético Madrid,La Liga,30,1992,28.3,55,38,23,25,7,28,72,38.9,44,35,13,22,20,75,19,0,Matches
1402,Sead Kolašinac,BIH,DF,Marseille,Ligue 1,29,1993,24.6,52,36,24,22,6,24,37,64.9,13,19,2,17,43,95,35,1,Matches
1403,Luca Koleosho,ITA,"FW,DF",Espanyol,La Liga,17,2004,0.7,2,2,0,0,2,1,2,50.0,1,1,0,1,0,2,0,0,Matches
1404,Randal Kolo Muani,FRA,FW,Eint Frankfurt,Bundesliga,23,1998,29.2,14,10,3,3,8,1,9,11.1,8,19,2,17,3,17,13,0,Matches
1405,Timothée Kolodziejczak,FRA,DF,Schalke 04,Bundesliga,30,1991,0.3,0,0,0,0,0,0,1,0.0,1,0,0,0,1,1,1,0,Matches
1406,Cheick Konaté,CIV,DF,Clermont Foot,Ligue 1,18,2004,6.4,19,12,10,7,2,13,22,59.1,9,7,1,6,13,32,8,1,Matches
1407,Ibrahima Konaté,FRA,DF,Liverpool,Premier League,23,1999,17.2,38,26,25,13,0,16,27,59.3,11,12,5,7,26,64,61,4,Matches
1408,Geoffrey Kondogbia,CTA,MF,Atlético Madrid,La Liga,29,1993,11.2,40,23,19,20,1,17,25,68.0,8,9,1,8,26,66,12,1,Matches
1409,Ibrahima Koné,MLI,FW,Lorient,Ligue 1,23,1999,17.5,24,13,3,13,8,5,11,45.5,6,13,0,13,4,28,18,0,Matches
1410,Kouadio Koné,FRA,MF,M'Gladbach,Bundesliga,21,2001,29.0,74,39,37,33,4,24,47,51.1,23,44,12,32,32,106,21,0,Matches
1411,Youssouf Koné,MLI,DF,Ajaccio,Ligue 1,27,1995,10.2,28,19,24,4,0,18,25,72.0,7,9,2,7,12,40,32,1,Matches
1412,Ezri Konsa,ENG,DF,Aston Villa,Premier League,24,1997,36.9,42,20,25,15,2,18,26,69.2,8,41,23,18,26,68,120,3,Matches
1413,Teun Koopmeiners,NED,MF,Atalanta,Serie A,24,1998,31.8,46,26,15,24,7,28,55,50.9,27,41,5,36,19,65,36,2,Matches
1414,Odilon Kossonou,CIV,DF,Leverkusen,Bundesliga,21,2001,16.9,21,14,12,7,2,8,16,50.0,8,26,11,15,24,45,58,1,Matches
1415,Filip Kostić,SRB,"DF,FW",Juventus,Serie A,29,1992,28.5,41,26,17,20,4,21,47,44.7,26,30,4,26,16,57,32,0,Matches
1416,Filip Kostić,SRB,"DF,MF",Eint Frankfurt,Bundesliga,29,1992,0.8,2,0,1,1,0,0,0,0.0,0,0,0,0,1,3,0,0,Matches
1417,Christian Kouamé,CIV,FW,Fiorentina,Serie A,24,1997,20.7,27,18,8,10,9,7,14,50.0,7,15,3,12,12,39,8,0,Matches
1418,Rominigue Kouamé,MLI,MF,Troyes,Ligue 1,25,1996,29.6,44,27,28,14,2,17,41,41.5,24,32,11,21,49,93,46,1,Matches
1419,Tomáš Koubek,CZE,GK,Augsburg,Bundesliga,29,1992,11.0,0,0,0,0,0,0,0,0.0,0,0,0,0,0,0,7,0,Matches
1420,Kalidou Koulibaly,SEN,DF,Chelsea,Premier League,31,1991,20.0,45,31,34,8,3,26,40,65.0,14,30,13,17,29,74,77,0,Matches
1421,Jules Koundé,FRA,DF,Barcelona,La Liga,23,1998,27.0,37,23,18,13,6,21,31,67.7,10,24,9,15,19,56,61,3,Matches
1422,Boubakar Kouyaté,MLI,DF,Montpellier,Ligue 1,25,1997,14.0,31,18,18,11,2,19,35,54.3,16,24,14,10,34,65,73,1,Matches
1423,Cheikhou Kouyaté,SEN,MF,Nott'ham Forest,Premier League,32,1989,9.8,29,21,18,8,3,9,13,69.2,4,14,2,12,10,39,24,0,Matches
1424,Mateo Kovačić,CRO,MF,Chelsea,Premier League,28,1994,19.0,36,24,16,14,6,14,36,38.9,22,10,1,9,19,55,16,0,Matches
1425,Viktor Kovalenko,UKR,MF,Spezia,Serie A,26,1996,6.1,9,5,1,6,2,5,8,62.5,3,11,2,9,4,13,7,0,Matches
1426,Soichiro Kozuki,JPN,"FW,MF",Schalke 04,Bundesliga,21,2000,4.2,6,4,3,3,0,4,6,66.7,2,5,0,5,3,9,3,0,Matches
1427,Emil Krafth,SWE,DF,Newcastle Utd,Premier League,27,1994,0.0,0,0,0,0,0,0,0,0.0,0,0,0,0,0,0,0,0,Matches
1428,Alex Král,CZE,MF,Schalke 04,Bundesliga,24,1998,26.2,34,24,10,22,2,17,37,45.9,20,31,6,25,17,51,53,0,Matches
1429,Andrej Kramarić,CRO,"MF,FW",Hoffenheim,Bundesliga,31,1991,26.5,5,2,2,1,2,1,11,9.1,10,14,2,12,6,11,13,0,Matches
1430,Christoph Kramer,GER,MF,M'Gladbach,Bundesliga,31,1991,24.7,44,33,24,15,5,22,55,40.0,33,34,2,32,17,61,40,0,Matches
1431,Tom Krauß,GER,MF,Schalke 04,Bundesliga,21,2001,27.9,112,68,39,62,11,51,100,51.0,49,39,6,33,36,148,35,0,Matches
1432,Julian Kristoffersen,NOR,FW,Salernitana,Serie A,25,1997,0.2,0,0,0,0,0,0,0,0.0,0,1,0,1,0,0,0,0,Matches
1433,Raimonds Krollis,LVA,"FW,DF",Spezia,Serie A,20,2001,0.4,1,1,0,0,1,0,1,0.0,1,0,0,0,0,1,0,0,Matches
1434,Toni Kroos,GER,MF,Real Madrid,La Liga,32,1990,23.9,51,32,16,33,2,23,69,33.3,46,23,4,19,24,75,11,0,Matches
1435,Rade Krunić,BIH,MF,Milan,Serie A,28,1993,18.4,40,28,18,18,4,16,50,32.0,34,31,11,20,16,56,21,0,Matches
1436,Max Kruse,GER,"MF,FW",Wolfsburg,Bundesliga,34,1988,3.0,1,1,0,1,0,0,1,0.0,1,2,1,1,0,1,1,0,Matches
1437,Lukas Kübler,GER,DF,Freiburg,Bundesliga,29,1992,18.2,37,25,24,9,4,18,30,60.0,12,25,11,14,29,66,50,0,Matches
1438,Takefusa Kubo,JPN,"FW,MF",Real Sociedad,La Liga,21,2001,27.1,44,26,18,16,10,16,38,42.1,22,29,1,28,9,53,4,0,Matches
1439,Dejan Kulusevski,SWE,"MF,FW",Tottenham,Premier League,22,2000,23.0,38,15,23,7,8,16,44,36.4,28,19,0,19,13,51,7,0,Matches
1440,Sael Kumbedi,FRA,DF,Lyon,Ligue 1,17,2005,14.7,47,27,27,13,7,20,38,52.6,18,23,7,16,10,57,16,0,Matches
1441,Marash Kumbulla,ALB,DF,Roma,Serie A,22,2000,2.9,4,4,2,2,0,2,3,66.7,1,2,1,1,4,8,6,0,Matches
1442,Pierre Kunde,CMR,"MF,FW",Bochum,Bundesliga,27,1995,4.2,12,6,3,8,1,6,14,42.9,8,7,1,6,7,19,9,0,Matches
1443,Alou Kuol,AUS,FW,Stuttgart,Bundesliga,21,2000,0.1,0,0,0,0,0,0,0,0.0,0,0,0,0,0,0,0,0,Matches
1444,Layvin Kurzawa,FRA,DF,Fulham,Premier League,29,1992,1.5,3,2,1,1,1,3,3,100.0,0,1,1,0,2,5,4,0,Matches
1445,Khvicha Kvaratskhelia,GEO,FW,Napoli,Serie A,21,2001,28.0,43,23,12,8,23,17,43,39.5,26,20,0,20,5,48,6,1,Matches
1446,Grejohn Kyei,FRA,FW,Clermont Foot,Ligue 1,26,1995,24.8,16,7,2,9,5,4,13,30.8,9,14,3,11,6,22,22,0,Matches
1447,Daniel Kyereh,GHA,"MF,FW",Freiburg,Bundesliga,26,1996,6.2,6,4,2,4,0,3,6,50.0,3,4,0,4,2,8,6,0,Matches
1448,Giorgos Kyriakopoulos,GRE,"DF,FW",Bologna,Serie A,26,1996,7.8,13,6,4,5,4,10,23,43.5,13,14,2,12,4,17,10,0,Matches
1449,Giorgos Kyriakopoulos,GRE,"FW,DF",Sassuolo,Serie A,26,1996,8.5,21,8,7,9,5,10,14,71.4,4,7,1,6,11,32,12,1,Matches
1450,César de la Hoz,ESP,MF,Almería,La Liga,30,1992,18.6,37,20,17,18,2,19,37,51.4,18,26,6,20,13,50,37,0,Matches
1451,Luca de la Torre,USA,MF,Celta Vigo,La Liga,24,1998,16.5,28,19,11,14,3,12,32,37.5,20,22,1,21,9,37,6,0,Matches
1452,Rémy Labeau Lascary,GLP,"FW,MF",Lens,Ligue 1,19,2003,1.4,4,2,4,0,0,0,0,0.0,0,4,0,4,1,5,0,0,Matches
1453,Gaëtan Laborde,FRA,FW,Nice,Ligue 1,28,1994,27.8,45,25,13,17,15,18,40,45.0,22,27,2,25,9,54,13,0,Matches
1454,Gaëtan Laborde,FRA,FW,Rennes,Ligue 1,28,1994,2.8,1,1,1,0,0,0,1,0.0,1,1,0,1,0,1,1,0,Matches
1455,Alexandre Lacazette,FRA,FW,Lyon,Ligue 1,31,1991,32.5,43,23,7,17,19,10,29,34.5,19,23,3,20,15,58,4,0,Matches
1456,Qazim Laçi,ALB,MF,Ajaccio,Ligue 1,26,1996,2.4,6,3,2,3,1,4,9,44.4,5,5,0,5,2,8,3,0,Matches
1457,Maxence Lacroix,FRA,DF,Wolfsburg,Bundesliga,22,2000,18.1,22,13,15,7,0,8,16,50.0,8,22,11,11,26,48,85,0,Matches
1458,Alban Lafont,FRA,GK,Nantes,Ligue 1,23,1999,37.0,0,0,0,0,0,0,1,0.0,1,0,0,0,0,0,20,4,Matches
1459,Aïssa Laïdouni,TUN,MF,Union Berlin,Bundesliga,25,1996,9.7,14,7,6,8,0,5,17,29.4,12,22,4,18,9,23,3,0,Matches
1460,Konrad Laimer,AUT,MF,RB Leipzig,Bundesliga,25,1997,16.3,60,31,23,30,7,30,54,55.6,24,31,4,27,18,78,8,0,Matches
1461,Stefan Lainer,AUT,DF,M'Gladbach,Bundesliga,29,1992,9.1,16,8,10,5,1,10,23,43.5,13,8,1,7,14,30,34,1,Matches
1462,Kenny Lala,FRA,DF,Brest,Ligue 1,30,1991,15.7,36,19,19,15,2,22,38,57.9,16,15,5,10,21,57,28,0,Matches
1463,Adam Lallana,ENG,"MF,FW",Brighton,Premier League,34,1988,8.0,9,4,6,2,1,0,7,0.0,7,6,0,6,2,11,1,0,Matches
1464,Vassilis Lambropoulos,GRE,DF,Bochum,Bundesliga,32,1990,7.0,10,8,7,3,0,6,9,66.7,3,5,3,2,13,23,41,0,Matches
1465,Érik Lamela,ARG,"FW,MF",Sevilla,La Liga,30,1992,20.5,46,27,14,16,16,12,34,35.3,22,26,2,24,7,53,3,0,Matches
1466,Mohamed Lamine Bayo,GUI,"FW,MF",Lille,Ligue 1,24,1998,7.2,3,3,0,2,1,0,12,0.0,12,3,1,2,0,3,1,0,Matches
1467,Sam Lammers,NED,FW,Sampdoria,Serie A,25,1997,12.2,12,5,2,7,3,6,15,40.0,9,10,3,7,6,18,11,0,Matches
1468,Sam Lammers,NED,FW,Empoli,Serie A,25,1997,9.8,20,10,5,9,6,7,11,63.6,4,4,1,3,3,23,8,0,Matches
1469,Tariq Lamptey,GHA,DF,Brighton,Premier League,21,2000,5.0,11,6,6,4,1,5,7,71.4,2,7,3,4,7,18,2,0,Matches
1470,Manuel Lanzini,ARG,"MF,FW",West Ham,Premier League,29,1993,2.8,2,2,1,1,0,2,6,33.3,4,2,0,2,2,4,0,0,Matches
1471,Aymeric Laporte,ESP,DF,Manchester City,Premier League,28,1994,11.0,11,8,6,4,1,7,11,63.6,4,10,4,6,3,14,30,1,Matches
1472,Julien Laporte,FRA,DF,Lorient,Ligue 1,28,1993,18.4,22,16,18,3,1,16,22,72.7,6,33,27,6,18,40,108,2,Matches
1473,Cyle Larin,CAN,FW,Valladolid,La Liga,27,1995,16.3,9,3,2,4,3,3,7,42.9,4,6,3,3,0,9,15,0,Matches
1474,Juan Larios,ESP,DF,Southampton,Premier League,18,2004,1.7,7,6,6,1,0,5,5,100.0,0,2,0,2,3,10,4,0,Matches
1475,Yasser Larouci,FRA,"DF,MF",Troyes,Ligue 1,21,2001,20.0,23,13,13,8,2,15,24,62.5,9,15,1,14,26,49,46,0,Matches
1476,Jordan Larsson,SWE,"FW,MF",Schalke 04,Bundesliga,25,1997,5.1,8,5,1,7,0,2,9,22.2,7,9,0,9,4,12,3,0,Matches
1477,Kevin Lasagna,ITA,"FW,MF",Hellas Verona,Serie A,29,1992,17.5,12,6,7,3,2,6,14,42.9,8,17,1,16,5,17,13,0,Matches
1478,Jamaal Lascelles,ENG,DF,Newcastle Utd,Premier League,28,1993,2.4,1,0,1,0,0,1,1,100.0,0,3,2,1,0,1,17,0,Matches
1479,Juanmi Latasa,ESP,FW,Getafe,La Liga,21,2001,5.0,5,4,2,0,3,1,1,100.0,0,3,1,2,1,6,8,0,Matches
1480,Toni Lato,ESP,"DF,MF",Valencia,La Liga,24,1997,10.2,23,11,9,12,2,9,21,42.9,12,10,1,9,6,29,14,0,Matches
1481,Danny Latza,GER,MF,Schalke 04,Bundesliga,32,1989,9.5,17,13,8,8,1,5,17,29.4,12,16,1,15,5,22,15,0,Matches
1482,Armand Lauriente,FRA,FW,Sassuolo,Serie A,23,1998,24.2,21,15,5,7,9,8,21,38.1,13,20,0,20,12,33,8,0,Matches
1483,Armand Lauriente,FRA,FW,Lorient,Ligue 1,23,1998,3.0,8,7,3,4,1,3,7,42.9,4,5,1,4,4,12,1,0,Matches
1484,Roméo Lavia,BEL,MF,Southampton,Premier League,18,2004,24.7,60,35,27,29,4,21,53,39.6,32,47,11,36,33,93,23,1,Matches
1485,Lázaro,BRA,"FW,MF",Almería,La Liga,20,2002,8.0,4,3,3,0,1,3,15,20.0,12,16,1,15,2,6,1,0,Matches
1486,Valentino Lazaro,AUT,DF,Torino,Serie A,26,1996,15.3,10,5,6,0,4,6,14,42.9,8,16,3,13,3,13,29,0,Matches
1487,Marko Lazetić,SRB,FW,Milan,Serie A,18,2004,0.1,0,0,0,0,0,0,0,0.0,0,0,0,0,0,0,0,0,Matches
1488,Darko Lazović,SRB,"MF,DF",Hellas Verona,Serie A,31,1990,24.9,24,13,9,12,3,13,29,44.8,16,14,3,11,16,40,19,0,Matches
1489,Manuel Lazzari,ITA,DF,Lazio,Serie A,28,1993,20.9,33,21,13,14,6,21,36,58.3,15,20,6,14,18,51,36,1,Matches
1490,Théo Le Bris,FRA,"MF,DF",Lorient,Ligue 1,19,2002,16.1,31,19,17,11,3,15,33,45.5,18,21,2,19,18,49,31,0,Matches
1491,Julien Le Cardinal,FRA,DF,Lens,Ligue 1,24,1997,1.8,6,4,5,0,1,4,6,66.7,2,3,0,3,2,8,5,0,Matches
1492,Jérémy Le Douaron,FRA,"MF,FW",Brest,Ligue 1,24,1998,23.0,15,9,5,9,1,3,27,11.1,24,29,2,27,11,26,30,0,Matches
1493,Enzo Le Fée,FRA,MF,Lorient,Ligue 1,22,2000,33.6,108,64,52,40,16,43,113,38.1,70,50,5,45,34,142,38,1,Matches
1494,Vincent Le Goff,FRA,DF,Lorient,Ligue 1,32,1989,37.0,75,32,56,16,3,45,62,72.6,17,29,9,20,41,116,105,1,Matches
1495,Maxime Le Marchand,FRA,DF,Strasbourg,Ligue 1,32,1989,22.4,39,24,23,14,2,19,31,61.3,12,22,14,8,37,76,74,0,Matches
1496,Robin Le Normand,ESP,DF,Real Sociedad,La Liga,25,1996,31.1,36,23,25,9,2,14,27,51.9,13,22,14,8,33,69,93,0,Matches
1497,Rafael Leão,POR,"FW,MF",Milan,Serie A,23,1999,26.9,8,7,2,3,3,6,14,42.9,8,9,2,7,15,23,8,0,Matches
1498,Paolo Lebas,POR,MF,Ajaccio,Ligue 1,19,2003,0.6,0,0,0,0,0,0,0,0.0,0,0,0,0,0,0,0,0,Matches
1499,Jean-Louis Leca,FRA,GK,Lens,Ligue 1,36,1985,1.0,0,0,0,0,0,0,0,0.0,0,0,0,0,0,0,0,1,Matches
1500,Benjamin Lecomte,FRA,GK,Espanyol,La Liga,31,1991,10.0,0,0,0,0,0,0,0,0.0,0,0,0,0,0,0,3,2,Matches
1501,Benjamin Lecomte,FRA,GK,Montpellier,Ligue 1,31,1991,19.0,0,0,0,0,0,0,2,0.0,2,0,0,0,0,0,6,0,Matches
1502,Jeremías Ledesma,ARG,GK,Cádiz,La Liga,29,1993,34.0,3,2,3,0,0,3,7,42.9,4,1,0,1,2,5,23,3,Matches
1503,Pierre Lees-Melou,FRA,MF,Brest,Ligue 1,29,1993,30.7,97,55,55,37,5,57,123,46.3,66,48,13,35,52,149,46,1,Matches
1504,Diogo Leite,POR,DF,Union Berlin,Bundesliga,23,1999,25.0,35,20,21,14,0,21,34,61.8,13,23,14,9,26,61,99,1,Matches
1505,Maxim Leitsch,GER,DF,Mainz 05,Bundesliga,24,1998,7.4,9,7,6,3,0,4,5,80.0,1,7,4,3,18,27,26,1,Matches
1506,Florian Lejeune,FRA,DF,Rayo Vallecano,La Liga,31,1991,28.5,28,17,19,8,1,17,25,68.0,8,24,16,8,15,43,123,0,Matches
1507,Iñigo Lekue,ESP,DF,Athletic Club,La Liga,29,1993,14.7,24,17,20,4,0,12,19,63.2,7,16,2,14,13,37,31,1,Matches
1508,Thomas Lemar,FRA,MF,Atlético Madrid,La Liga,26,1995,13.9,30,18,10,13,7,10,28,35.7,18,12,3,9,7,37,12,0,Matches
1509,Félix Lemaréchal,FRA,MF,Brest,Ligue 1,18,2003,3.2,5,5,2,1,2,0,3,0.0,3,6,0,6,1,6,2,0,Matches
1510,Dexter Lembikisa,JAM,DF,Wolves,Premier League,18,2003,0.3,0,0,0,0,0,0,0,0.0,0,0,0,0,0,0,0,0,Matches
1511,Mario Lemina,GAB,MF,Wolves,Premier League,28,1993,14.4,38,24,22,13,3,20,38,52.6,18,26,8,18,14,52,24,1,Matches
1512,Mario Lemina,GAB,"MF,DF",Nice,Ligue 1,28,1993,9.3,32,21,11,14,7,12,18,66.7,6,13,5,8,11,43,20,0,Matches
1513,Tim Lemperle,GER,"FW,MF",Köln,Bundesliga,20,2002,1.5,6,4,3,1,2,3,5,60.0,2,5,0,5,1,7,4,0,Matches
1514,Clément Lenglet,FRA,DF,Tottenham,Premier League,27,1995,22.4,38,23,18,15,5,16,34,47.1,18,26,11,15,18,56,68,2,Matches
1515,Bernd Leno,GER,GK,Fulham,Premier League,30,1992,36.0,0,0,0,0,0,0,2,0.0,2,0,0,0,0,0,18,0,Matches
1516,Christopher Lenz,GER,DF,Eint Frankfurt,Bundesliga,27,1994,14.3,29,21,17,7,5,16,37,43.2,21,16,3,13,21,50,34,0,Matches
1517,Donovan Léon,GUF,GK,Auxerre,Ligue 1,29,1992,2.0,0,0,0,0,0,0,0,0.0,0,0,0,0,0,0,1,0,Matches
1518,Sergio León,ESP,FW,Valladolid,La Liga,33,1989,14.8,6,4,0,4,2,3,6,50.0,3,6,0,6,0,6,4,0,Matches
1519,Johann Lepenant,FRA,MF,Lyon,Ligue 1,19,2002,21.5,58,34,24,27,7,32,86,37.2,54,29,5,24,28,86,17,3,Matches
1520,Mehdi Léris,ALG,"MF,DF",Sampdoria,Serie A,24,1998,27.3,63,46,30,24,9,23,55,41.8,32,38,6,32,27,90,34,0,Matches
1521,Jefferson Lerma,COL,MF,Bournemouth,Premier League,27,1994,36.1,50,30,23,23,4,20,45,44.4,25,32,15,17,47,97,91,1,Matches
1522,Benjamin Leroy,FRA,GK,Ajaccio,Ligue 1,33,1989,31.1,0,0,0,0,0,0,2,0.0,2,0,0,0,1,1,16,2,Matches
1523,Léo Leroy,FRA,MF,Montpellier,Ligue 1,22,2000,13.2,53,38,24,26,3,31,57,54.4,26,25,2,23,14,67,8,0,Matches
1524,Alexandre Letellier,FRA,GK,Paris S-G,Ligue 1,31,1990,0.1,0,0,0,0,0,0,0,0.0,0,0,0,0,0,0,0,0,Matches
1525,Ruan Levine,BRA,"MF,FW",Ajaccio,Ligue 1,23,1999,0.3,2,2,1,1,0,0,0,0.0,0,1,0,1,2,4,0,0,Matches
1526,Robert Lewandowski,POL,FW,Barcelona,La Liga,33,1988,31.6,17,11,2,5,10,7,14,50.0,7,20,0,20,2,19,14,0,Matches
1527,Jamie Leweling,GER,"FW,MF",Union Berlin,Bundesliga,21,2001,2.9,5,3,2,2,1,3,5,60.0,2,3,0,3,1,6,0,0,Matches
1528,Jamal Lewis,NIR,"DF,FW",Newcastle Utd,Premier League,24,1998,0.1,0,0,0,0,0,0,0,0.0,0,0,0,0,0,0,0,0,Matches
1529,Rico Lewis,ENG,"DF,MF",Manchester City,Premier League,17,2004,10.0,16,9,9,5,2,6,11,54.5,5,8,4,4,6,22,13,1,Matches
1530,Keane Lewis-Potter,ENG,"FW,MF",Brentford,Premier League,21,2001,3.6,1,0,0,1,0,0,0,0.0,0,5,1,4,0,1,2,0,Matches
1531,Dimitri Liénard,FRA,"DF,MF",Strasbourg,Ligue 1,34,1988,17.1,46,29,20,18,8,34,57,59.6,23,28,4,24,16,62,24,0,Matches
1532,Philipp Lienhart,AUT,DF,Freiburg,Bundesliga,26,1996,27.8,29,18,19,10,0,13,27,48.1,14,29,15,14,35,64,97,0,Matches
1533,Matthijs de Ligt,NED,DF,Bayern Munich,Bundesliga,22,1999,26.7,32,23,15,16,1,15,24,62.5,9,31,20,11,23,55,85,0,Matches
1534,Dimitris Limnios,GRE,FW,Köln,Bundesliga,24,1998,0.4,0,0,0,0,0,0,0,0.0,0,0,0,0,1,1,0,0,Matches
1535,Victor Lindelöf,SWE,DF,Manchester Utd,Premier League,28,1994,15.2,22,17,10,9,3,9,17,52.9,8,18,9,9,21,43,63,1,Matches
1536,Jesper Lindstrøm,DEN,"MF,FW",Eint Frankfurt,Bundesliga,22,2000,18.7,26,11,15,7,4,7,22,31.8,15,25,3,22,9,35,9,0,Matches
1537,Karol Linetty,POL,MF,Torino,Serie A,27,1995,21.0,32,17,7,22,3,13,25,52.0,12,28,8,20,19,51,25,0,Matches
1538,Jesse Lingard,ENG,"FW,MF",Nott'ham Forest,Premier League,29,1992,10.3,4,4,2,2,0,1,7,14.3,6,11,0,11,5,9,4,0,Matches
1539,Pol Lirola,ESP,DF,Elche,La Liga,24,1997,7.0,13,6,9,3,1,8,13,61.5,5,3,2,1,7,20,16,0,Matches
1540,Mateusz Lis,POL,GK,Troyes,Ligue 1,25,1997,8.3,0,0,0,0,0,0,1,0.0,1,1,0,1,0,0,3,0,Matches
1541,Marcin Listkowski,POL,"MF,FW",Lecce,Serie A,24,1998,0.9,0,0,0,0,0,0,0,0.0,0,0,0,0,3,3,2,0,Matches
1542,Valentino Livramento,ENG,"DF,FW",Southampton,Premier League,19,2002,0.3,2,1,2,0,0,0,0,0.0,0,0,0,0,2,4,3,0,Matches
1543,Dejan Ljubicic,AUT,"MF,FW",Köln,Bundesliga,24,1997,19.0,25,14,7,14,4,13,40,32.5,27,20,1,19,8,33,8,1,Matches
1544,Javier Llabrés,ESP,FW,Mallorca,La Liga,19,2002,0.2,0,0,0,0,0,0,0,0.0,0,0,0,0,0,0,1,0,Matches
1545,Diego Llorente,ESP,DF,Leeds United,Premier League,28,1993,7.2,13,10,8,5,0,4,8,50.0,4,6,2,4,15,28,24,2,Matches
1546,Diego Llorente,ESP,DF,Roma,Serie A,28,1993,6.4,10,5,6,4,0,5,12,41.7,7,4,2,2,11,21,20,0,Matches
1547,Marcos Llorente,ESP,"MF,DF",Atlético Madrid,La Liga,27,1995,18.9,32,15,16,10,6,17,30,56.7,13,26,2,24,17,49,19,0,Matches
1548,Hugo Lloris,FRA,GK,Tottenham,Premier League,35,1986,24.5,1,1,1,0,0,1,3,33.3,2,0,0,0,1,2,13,4,Matches
1549,Giovani Lo Celso,ARG,"MF,FW",Villarreal,La Liga,26,1996,12.5,32,28,7,15,10,12,21,57.1,9,14,2,12,6,38,5,0,Matches
1550,Stanislav Lobotka,SVK,MF,Napoli,Serie A,27,1994,34.5,83,44,35,35,13,43,73,58.9,30,29,7,22,23,106,16,0,Matches
1551,Manuel Locatelli,ITA,MF,Juventus,Serie A,24,1998,27.2,59,33,26,23,10,30,53,56.6,23,50,22,28,27,86,59,0,Matches
1552,Luka Lochoshvili,GEO,DF,Cremonese,Serie A,24,1998,20.4,45,19,30,11,4,22,31,71.0,9,31,10,21,22,67,89,0,Matches
1553,Bradley Locko,FRA,DF,Reims,Ligue 1,20,2002,11.8,31,16,21,4,6,15,27,55.6,12,17,4,13,20,51,21,0,Matches
1554,Bradley Locko,FRA,DF,Brest,Ligue 1,20,2002,3.0,4,3,2,1,1,2,3,66.7,1,4,0,4,2,6,13,0,Matches
1555,Renan Lodi,BRA,DF,Nott'ham Forest,Premier League,24,1998,24.6,52,39,38,8,6,33,66,50.0,33,25,6,19,33,85,74,0,Matches
1556,Ruben Loftus-Cheek,ENG,"MF,DF",Chelsea,Premier League,26,1996,17.1,25,14,8,14,3,12,21,57.1,9,15,2,13,12,37,23,0,Matches
1557,Sean Longstaff,ENG,MF,Newcastle Utd,Premier League,24,1997,28.0,42,21,16,20,6,20,52,38.5,32,35,8,27,16,58,23,0,Matches
1558,Ademola Lookman,NGA,"FW,MF",Atalanta,Serie A,24,1997,19.2,13,5,2,6,5,3,15,20.0,12,18,0,18,4,17,1,0,Matches
1559,Anthony Lopes,POR,GK,Lyon,Ligue 1,31,1990,31.3,1,0,1,0,0,1,4,25.0,3,0,0,0,3,4,10,0,Matches
1560,Rony Lopes,POR,"MF,FW",Troyes,Ligue 1,26,1995,26.1,24,12,6,15,3,7,31,22.6,24,14,2,12,9,33,10,0,Matches
1561,David López,ESP,DF,Girona,La Liga,32,1989,18.4,31,18,17,13,1,19,27,70.4,8,29,19,10,14,45,64,1,Matches
1562,Diego López,ESP,GK,Rayo Vallecano,La Liga,40,1981,1.1,0,0,0,0,0,0,0,0.0,0,0,0,0,0,0,0,1,Matches
1563,Diego López,ESP,"FW,MF",Valencia,La Liga,20,2002,5.0,2,2,1,1,0,2,15,13.3,13,9,0,9,3,5,5,0,Matches
1564,Maxime Lopez,FRA,MF,Sassuolo,Serie A,24,1997,25.5,42,18,26,12,4,16,56,28.6,40,24,6,18,22,64,21,0,Matches
1565,Pau López,ESP,GK,Marseille,Ligue 1,27,1994,32.5,0,0,0,0,0,0,1,0.0,1,0,0,0,0,0,5,1,Matches
1566,Unai López,ESP,MF,Rayo Vallecano,La Liga,26,1995,13.9,32,20,10,17,5,13,37,35.1,24,12,1,11,15,47,6,1,Matches
1567,Dion Lopy,SEN,MF,Reims,Ligue 1,20,2002,15.3,45,24,22,16,7,23,62,37.1,39,27,3,24,22,67,18,0,Matches
1568,Anthony Losilla,FRA,MF,Bochum,Bundesliga,36,1986,30.2,76,49,32,34,10,38,77,49.4,39,39,12,27,37,113,67,0,Matches
1569,Jordan Lotomba,SUI,DF,Nice,Ligue 1,23,1998,27.3,65,38,33,24,8,31,48,64.6,17,38,11,27,32,97,53,0,Matches
1570,Matteo Lovato,ITA,DF,Salernitana,Serie A,22,2000,9.0,17,14,14,3,0,10,25,40.0,15,8,5,3,13,30,33,2,Matches
1571,Dejan Lovren,CRO,DF,Lyon,Ligue 1,33,1989,16.2,25,19,20,5,0,20,29,69.0,9,20,10,10,26,51,70,1,Matches
1572,Sandi Lovrić,SVN,MF,Udinese,Serie A,24,1998,25.9,40,18,16,16,8,25,43,58.1,18,25,2,23,26,66,21,0,Matches
1573,Jamal Lowe,JAM,"MF,FW",Bournemouth,Premier League,28,1994,0.1,0,0,0,0,0,0,0,0.0,0,0,0,0,0,0,0,0,Matches
1574,Anthony Lozano,HON,FW,Cádiz,La Liga,29,1993,16.0,6,4,1,4,1,1,7,14.3,6,12,1,11,3,9,17,0,Matches
1575,Hirving Lozano,MEX,FW,Napoli,Serie A,27,1995,17.8,24,13,10,6,8,9,21,42.9,12,31,0,31,15,39,6,0,Matches
1576,Pol Lozano,ESP,MF,Espanyol,La Liga,22,1999,0.2,0,0,0,0,0,0,0,0.0,0,1,0,1,0,0,1,0,Matches
1577,Jean Lucas,BRA,MF,Monaco,Ligue 1,24,1998,3.2,9,5,3,5,1,6,12,50.0,6,2,1,1,4,13,2,0,Matches
1578,Jhon Lucumí,COL,DF,Bologna,Serie A,24,1998,32.2,53,37,39,13,1,24,43,55.8,19,43,26,17,35,88,100,1,Matches
1579,José Luis Gayà,ESP,DF,Valencia,La Liga,27,1995,30.1,80,46,61,16,3,43,74,58.1,31,28,9,19,23,103,48,0,Matches
1580,José Luis Morales,ESP,"FW,MF",Villarreal,La Liga,35,1987,13.5,7,6,1,2,4,5,17,29.4,12,12,1,11,2,9,2,0,Matches
1581,José Luis Palomino,ARG,DF,Atalanta,Serie A,32,1990,8.4,23,14,16,7,0,11,19,57.9,8,11,4,7,28,51,20,0,Matches
1582,Douglas Luiz,BRA,MF,Aston Villa,Premier League,24,1998,32.5,73,42,31,32,10,30,63,47.6,33,36,7,29,40,113,27,2,Matches
1583,Romelu Lukaku,BEL,FW,Inter,Serie A,29,1993,18.4,3,1,1,0,2,2,5,40.0,3,3,1,2,0,3,16,0,Matches
1584,Castello Lukeba,FRA,DF,Lyon,Ligue 1,19,2002,33.2,39,23,27,8,4,21,31,67.7,10,42,24,18,75,114,105,1,Matches
1585,Dodi Lukebakio,BEL,"FW,MF",Hertha BSC,Bundesliga,24,1997,26.6,18,11,7,8,3,6,27,22.2,21,23,5,18,13,31,17,0,Matches
1586,Saša Lukić,SRB,MF,Fulham,Premier League,25,1996,4.6,8,3,1,4,3,3,7,42.9,4,6,2,4,5,13,3,0,Matches
1587,Saša Lukić,SRB,MF,Torino,Serie A,25,1996,13.3,21,14,10,10,1,9,15,60.0,6,17,7,10,13,34,10,0,Matches
1588,Andriy Lunin,UKR,GK,Real Madrid,La Liga,23,1999,7.0,0,0,0,0,0,0,0,0.0,0,0,0,0,0,0,1,0,Matches
1589,Andrey Lunyov,RUS,GK,Leverkusen,Bundesliga,30,1991,1.0,0,0,0,0,0,0,0,0.0,0,0,0,0,0,0,0,0,Matches
1590,Sebastiano Luperto,ITA,DF,Empoli,Serie A,25,1996,34.8,33,18,24,8,1,9,20,45.0,11,54,42,12,43,76,163,1,Matches
1591,Lyanco,BRA,DF,Southampton,Premier League,25,1997,13.1,24,16,15,9,0,12,18,66.7,6,30,25,5,20,44,65,2,Matches
1592,Charalambos Lykogiannis,GRE,DF,Bologna,Serie A,28,1993,12.3,16,8,5,6,5,5,13,38.5,8,9,4,5,15,31,30,0,Matches
1593,Youssouf M'Changama,COM,MF,Auxerre,Ligue 1,31,1990,12.0,22,11,7,12,3,7,13,53.8,6,6,0,6,15,37,6,1,Matches
1594,Awer Mabil,AUS,"MF,FW",Cádiz,La Liga,26,1995,1.8,2,0,0,1,1,1,3,33.3,2,1,1,0,0,2,1,0,Matches
1595,Alexis Mac Allister,ARG,MF,Brighton,Premier League,23,1998,32.1,70,39,22,40,8,34,70,48.6,36,26,2,24,22,92,10,1,Matches
1596,Deiver Machado,COL,"DF,MF",Lens,Ligue 1,28,1993,24.3,45,26,18,20,7,21,34,61.8,13,21,4,17,21,66,27,0,Matches
1597,Darwin Machís,VEN,FW,Valladolid,La Liga,29,1993,6.7,3,2,0,2,1,1,8,12.5,7,5,0,5,3,6,4,0,Matches
1598,James Maddison,ENG,"MF,FW",Leicester City,Premier League,25,1996,27.6,51,26,25,19,7,19,50,38.0,31,19,1,18,13,64,6,1,Matches
1599,Noni Madueke,ENG,FW,Chelsea,Premier League,20,2002,7.1,12,8,5,4,3,6,13,46.2,7,13,2,11,4,16,7,0,Matches
1600,Pablo Maffeo,ESP,DF,Mallorca,La Liga,25,1997,33.1,75,46,54,16,5,45,78,57.7,33,38,11,27,26,101,76,0,Matches
1601,Lisandro Magallán,ARG,DF,Elche,La Liga,28,1993,10.0,19,11,11,5,3,10,12,83.3,2,14,5,9,13,32,30,1,Matches
1602,Soungoutou Magassa,FRA,MF,Monaco,Ligue 1,18,2003,0.9,4,1,2,2,0,2,4,50.0,2,3,0,3,1,5,1,0,Matches
1603,Giulio Maggiore,ITA,MF,Salernitana,Serie A,24,1998,9.9,20,8,11,6,3,10,21,47.6,11,19,4,15,8,28,10,0,Matches
1604,Giangiacomo Magnani,ITA,DF,Hellas Verona,Serie A,26,1995,17.0,33,22,20,11,2,19,25,76.0,6,20,15,5,21,54,76,0,Matches
1605,Hugo Magnetti,FRA,MF,Brest,Ligue 1,24,1998,18.8,43,27,18,23,2,23,63,36.5,40,21,1,20,25,68,12,0,Matches
1606,Yohann Magnin,FRA,MF,Clermont Foot,Ligue 1,25,1997,26.7,89,54,37,45,7,54,106,50.9,52,50,12,38,25,114,46,0,Matches
1607,Harry Maguire,ENG,DF,Manchester Utd,Premier League,29,1993,8.5,8,6,6,1,1,4,5,80.0,1,18,11,7,13,21,41,0,Matches
1608,Jon Magunacelaya,ESP,"MF,FW",Real Sociedad,La Liga,22,2000,0.7,1,0,0,0,1,0,2,0.0,2,0,0,0,0,1,1,0,Matches
1609,Riyad Mahrez,ALG,"FW,MF",Manchester City,Premier League,31,1991,21.3,30,14,8,13,9,13,38,34.2,25,27,1,26,9,39,5,0,Matches
1610,Arne Maier,GER,MF,Augsburg,Bundesliga,23,1999,21.8,31,22,17,11,3,10,18,55.6,8,21,0,21,15,46,22,0,Matches
1611,Mike Maignan,FRA,GK,Milan,Serie A,27,1995,22.0,1,0,1,0,0,1,1,100.0,0,0,0,0,1,2,10,1,Matches
1612,Linton Maina,GER,"FW,MF",Köln,Bundesliga,23,1999,24.9,18,12,5,11,2,7,30,23.3,23,19,0,19,5,23,9,0,Matches
1613,Kobbie Mainoo,ENG,MF,Manchester Utd,Premier League,17,2005,0.1,0,0,0,0,0,0,0,0.0,0,1,1,0,0,0,0,0,Matches
1614,Ainsley Maitland-Niles,ENG,"DF,MF",Southampton,Premier League,24,1997,15.6,45,24,23,18,4,28,44,63.6,16,28,7,21,22,67,45,1,Matches
1615,Jordan Majchrzak,POL,FW,Roma,Serie A,17,2004,0.2,0,0,0,0,0,0,0,0.0,0,0,0,0,0,0,0,0,Matches
1616,Lovro Majer,CRO,"MF,FW",Rennes,Ligue 1,24,1998,18.5,34,23,16,13,5,8,29,27.6,21,21,1,20,21,55,5,1,Matches
1617,Jean-Victor Makengo,FRA,MF,Udinese,Serie A,24,1998,8.9,16,13,7,7,2,5,9,55.6,4,8,2,6,9,25,3,0,Matches
1618,Jean-Victor Makengo,FRA,MF,Lorient,Ligue 1,24,1998,11.8,16,8,5,10,1,6,20,30.0,14,8,5,3,10,26,13,1,Matches
1619,Béni Makouana,CGO,"FW,MF",Montpellier,Ligue 1,19,2002,2.2,1,0,0,1,0,0,2,0.0,2,3,1,2,0,1,1,0,Matches
1620,Nemanja Maksimović,SRB,MF,Getafe,La Liga,27,1995,22.8,41,30,17,18,6,19,32,59.4,13,36,14,22,34,75,27,0,Matches
1621,Tyrell Malacia,NED,DF,Manchester Utd,Premier League,22,1999,15.5,46,33,33,12,1,14,25,56.0,11,13,3,10,25,71,49,0,Matches
1622,Lorenzo Malagrida,ITA,"MF,DF",Sampdoria,Serie A,18,2003,1.2,1,0,0,0,1,1,3,33.3,2,1,0,1,0,1,1,0,Matches
1623,Daniel Maldini,ITA,"FW,MF",Spezia,Serie A,20,2001,7.0,12,5,3,4,5,4,11,36.4,7,9,0,9,1,13,8,0,Matches
1624,Youssef Maleh,MAR,MF,Fiorentina,Serie A,23,1998,3.3,3,1,0,3,0,0,4,0.0,4,5,0,5,1,4,3,0,Matches
1625,Youssef Maleh,MAR,MF,Lecce,Serie A,23,1998,7.5,17,8,3,7,7,6,14,42.9,8,20,1,19,5,22,10,0,Matches
1626,Donyell Malen,NED,FW,Dortmund,Bundesliga,23,1999,19.0,13,5,3,4,6,5,12,41.7,7,14,1,13,4,17,11,0,Matches
1627,Ruslan Malinovskyi,UKR,"MF,FW",Atalanta,Serie A,29,1993,6.1,14,8,5,6,3,6,17,35.3,11,8,1,7,5,19,2,0,Matches
1628,Ruslan Malinovskyi,UKR,"MF,FW",Marseille,Ligue 1,29,1993,13.6,21,11,3,12,6,10,26,38.5,16,13,1,12,3,24,9,0,Matches
1629,Hugo Mallo,ESP,DF,Celta Vigo,La Liga,31,1991,24.0,53,29,34,14,5,28,42,66.7,14,28,7,21,24,77,73,0,Matches
1630,Mickael Malsa,MTQ,MF,Valladolid,La Liga,26,1995,0.8,2,2,1,1,0,1,4,25.0,3,1,1,0,2,4,3,0,Matches
1631,Giorgi Mamardashvili,GEO,GK,Valencia,La Liga,21,2000,38.0,0,0,0,0,0,0,0,0.0,0,0,0,0,1,1,11,4,Matches
1632,Hianga Mananga Mbock,FRA,MF,Brest,Ligue 1,22,1999,0.2,0,0,0,0,0,0,1,0.0,1,0,0,0,0,0,0,0,Matches
1633,Gianluca Mancini,ITA,DF,Roma,Serie A,26,1996,31.8,37,19,27,9,1,18,34,52.9,16,38,17,21,46,83,67,0,Matches
1634,Steve Mandanda,FRA,GK,Rennes,Ligue 1,37,1985,33.5,0,0,0,0,0,0,2,0.0,2,0,0,0,0,0,9,3,Matches
1635,Reinildo Mandava,MOZ,DF,Atlético Madrid,La Liga,28,1994,20.6,66,43,46,19,1,38,49,77.6,11,27,12,15,30,96,59,0,Matches
1636,Aïssa Mandi,ALG,DF,Villarreal,La Liga,30,1991,16.2,18,10,14,3,1,6,12,50.0,6,19,14,5,21,39,58,0,Matches
1637,Rolando Mandragora,ITA,MF,Fiorentina,Serie A,25,1997,21.7,42,24,12,22,8,23,52,44.2,29,25,3,22,16,58,21,0,Matches
1638,Sadio Mané,SEN,"FW,MF",Bayern Munich,Bundesliga,30,1992,15.8,11,5,3,3,5,1,9,11.1,8,15,2,13,0,11,4,0,Matches
1639,Orel Mangala,BEL,MF,Nott'ham Forest,Premier League,24,1998,17.2,28,20,16,10,2,12,29,41.4,17,21,7,14,23,51,15,0,Matches
1640,Thomas Mangani,FRA,MF,Ajaccio,Ligue 1,35,1987,14.8,32,17,14,15,3,18,47,38.3,29,22,3,19,24,56,22,1,Matches
1641,Vito Mannone,ITA,GK,Lorient,Ligue 1,34,1988,17.9,0,0,0,0,0,0,0,0.0,0,0,0,0,0,0,4,3,Matches
1642,Javier Manquillo,ESP,DF,Newcastle Utd,Premier League,28,1994,0.4,3,2,2,1,0,2,2,100.0,0,1,0,1,1,4,1,0,Matches
1643,Myziane Maolida,FRA,"MF,FW",Reims,Ligue 1,23,1999,2.6,8,3,2,5,1,5,12,41.7,7,1,0,1,2,10,0,0,Matches
1644,Myziane Maolida,FRA,"FW,MF",Hertha BSC,Bundesliga,23,1999,1.1,1,1,1,0,0,1,2,50.0,1,0,0,0,0,1,1,0,Matches
1645,Faitout Maouassa,FRA,"FW,DF",Montpellier,Ligue 1,24,1998,21.4,52,32,26,20,6,18,41,43.9,23,31,3,28,20,72,23,0,Matches
1646,Sekou Mara,FRA,"FW,MF",Southampton,Premier League,20,2002,6.2,14,10,5,8,1,3,9,33.3,6,11,0,11,1,15,5,0,Matches
1647,Marcão,BRA,DF,Sevilla,La Liga,26,1996,4.2,2,2,1,1,0,1,1,100.0,0,3,3,0,6,8,14,0,Matches
1648,Solly March,ENG,"FW,DF",Brighton,Premier League,28,1994,30.2,53,31,16,17,20,8,28,28.6,20,34,3,31,24,77,32,0,Matches
1649,Agustín Marchesín,ARG,GK,Celta Vigo,La Liga,34,1988,19.0,0,0,0,0,0,0,1,0.0,1,0,0,0,0,0,7,0,Matches
1650,Federico Marchetti,ITA,GK,Spezia,Serie A,39,1983,0.7,0,0,0,0,0,0,0,0.0,0,0,0,0,0,0,0,0,Matches
1651,Vincent Marchetti,FRA,MF,Ajaccio,Ligue 1,25,1997,27.2,55,26,29,19,7,25,68,36.8,43,23,3,20,19,74,31,0,Matches
1652,Riccardo Marchizza,ITA,DF,Sassuolo,Serie A,24,1998,3.1,2,2,1,1,0,2,4,50.0,2,2,0,2,2,4,8,0,Matches
1653,Gian Marco Ferrari,ITA,DF,Sassuolo,Serie A,30,1992,24.7,23,16,11,10,2,10,17,58.8,7,29,20,9,23,46,81,4,Matches
1654,Emiliano Marcondes,DEN,MF,Bournemouth,Premier League,27,1995,0.1,0,0,0,0,0,0,0,0.0,0,0,0,0,0,0,1,0,Matches
1655,Óscar de Marcos,ESP,DF,Athletic Club,La Liga,33,1989,31.3,67,33,34,22,11,40,76,52.6,36,42,6,36,29,96,59,0,Matches
1656,Alberto Marí,ESP,"FW,MF",Valencia,La Liga,21,2001,1.0,0,0,0,0,0,0,2,0.0,2,0,0,0,0,0,1,0,Matches
1657,José Mari,ESP,MF,Cádiz,La Liga,34,1987,4.4,16,7,12,3,1,10,16,62.5,6,3,1,2,5,21,9,0,Matches
1658,Pablo Marí,ESP,DF,Monza,Serie A,28,1993,27.6,37,19,29,7,1,17,26,65.4,9,22,14,8,31,68,111,3,Matches
1659,José María Giménez,URU,DF,Atlético Madrid,La Liga,27,1995,26.9,43,25,28,14,1,24,35,68.6,11,37,17,20,24,67,138,1,Matches
1660,Mariano,DOM,FW,Real Madrid,La Liga,28,1993,1.7,1,0,0,1,0,0,0,0.0,0,1,0,1,0,1,0,0,Matches
1661,Pablo Marín,ESP,"MF,FW",Real Sociedad,La Liga,19,2003,4.0,10,5,5,4,1,2,7,28.6,5,1,0,1,4,14,2,0,Matches
1662,Răzvan Marin,ROU,MF,Empoli,Serie A,26,1996,28.2,44,22,22,21,1,19,40,47.5,21,29,11,18,14,58,33,0,Matches
1663,Diego Mariño,ESP,GK,Almería,La Liga,32,1990,0.5,0,0,0,0,0,0,0,0.0,0,0,0,0,0,0,0,0,Matches
1664,Guillermo Maripán,CHI,DF,Monaco,Ligue 1,28,1994,24.0,46,26,26,20,0,17,33,51.5,16,39,27,12,38,84,87,0,Matches
1665,Marlon,BRA,DF,Monza,Serie A,26,1995,17.7,35,21,20,14,1,15,29,51.7,14,13,4,9,18,53,50,0,Matches
1666,Omar Marmoush,EGY,FW,Wolfsburg,Bundesliga,23,1999,16.4,0,10,0,0,0,0,0,0.0,0,0,0,0,5,0,0,0,Matches
1667,Marquinhos,BRA,MF,Arsenal,Premier League,19,2003,0.0,0,0,0,0,0,0,0,0.0,0,0,0,0,0,0,0,0,Matches
1668,Marquinhos,BRA,DF,Paris S-G,Ligue 1,28,1994,30.2,33,25,18,12,3,18,26,69.2,8,43,27,16,23,56,83,2,Matches
1669,Luca Marrone,ITA,DF,Monza,Serie A,32,1990,1.5,0,0,0,0,0,0,2,0.0,2,2,2,0,0,0,4,1,Matches
1670,Eric Martel,GER,MF,Köln,Bundesliga,20,2002,22.4,66,41,29,30,7,30,60,50.0,30,29,9,20,33,99,49,0,Matches
1671,Roger Martí,ESP,FW,Elche,La Liga,31,1991,7.3,5,2,3,2,0,1,5,20.0,4,4,0,4,1,6,7,0,Matches
1672,Roger Martí,ESP,FW,Cádiz,La Liga,31,1991,7.1,6,4,2,3,1,1,8,12.5,7,7,0,7,2,8,7,0,Matches
1673,Anthony Martial,FRA,FW,Manchester Utd,Premier League,26,1995,10.9,5,3,0,2,3,1,4,25.0,3,11,2,9,1,6,4,0,Matches
1674,Aarón Martín,ESP,DF,Mainz 05,Bundesliga,25,1997,20.5,42,27,25,11,6,21,40,52.5,19,22,1,21,15,57,31,0,Matches
1675,Ander Martin,ESP,"MF,FW",Real Sociedad,La Liga,21,2000,0.5,2,2,1,1,0,1,4,25.0,3,0,0,0,0,2,1,0,Matches
1676,Andrés Martín,ESP,"FW,MF",Rayo Vallecano,La Liga,23,1999,2.3,4,2,2,1,1,3,5,60.0,2,2,0,2,1,5,2,0,Matches
1677,Carlos Martín,ESP,"FW,MF",Atlético Madrid,La Liga,20,2002,0.3,2,2,0,2,0,2,3,66.7,1,0,0,0,1,3,0,0,Matches
1678,Iván Martín,ESP,MF,Girona,La Liga,23,1999,17.6,9,7,4,4,1,8,23,34.8,15,12,0,12,9,18,12,0,Matches
1679,Jonas Martin,FRA,MF,Lille,Ligue 1,32,1990,3.1,9,7,4,5,0,5,14,35.7,9,3,1,2,7,16,3,0,Matches
1680,Gabriel Martinelli,BRA,FW,Arsenal,Premier League,21,2001,31.0,31,18,13,12,6,9,22,40.9,13,24,1,23,9,40,14,0,Matches
1681,Arnau Martinez,ESP,DF,Girona,La Liga,19,2003,30.4,69,45,41,19,9,38,85,44.7,47,44,10,34,25,94,54,2,Matches
1682,Emiliano Martínez,ARG,GK,Aston Villa,Premier League,29,1992,34.9,0,0,0,0,0,0,2,0.0,2,0,0,0,1,1,23,1,Matches
1683,Iñigo Martínez,ESP,DF,Athletic Club,La Liga,31,1991,14.9,18,8,11,7,0,6,9,66.7,3,17,11,6,18,36,55,0,Matches
1684,Lautaro Martínez,ARG,FW,Inter,Serie A,24,1997,28.6,25,14,3,15,7,7,23,30.4,16,31,1,30,13,38,16,1,Matches
1685,Lisandro Martínez,ARG,DF,Manchester Utd,Premier League,24,1998,23.5,54,28,33,18,3,30,43,69.8,13,51,27,24,33,87,103,0,Matches
1686,Lucas Martínez Quarta,ARG,DF,Fiorentina,Serie A,26,1996,24.1,80,48,44,32,4,42,61,68.9,19,41,19,22,48,128,78,1,Matches
1687,Roger Martínez,ESP,DF,Espanyol,La Liga,18,2004,0.1,0,0,0,0,0,0,0,0.0,0,0,0,0,0,0,0,0,Matches
1688,Gelson Martins,POR,"MF,FW",Monaco,Ligue 1,27,1995,3.8,15,8,6,4,5,4,13,30.8,9,4,1,3,3,18,2,0,Matches
1689,Adam Marušić,MNE,DF,Lazio,Serie A,29,1992,30.7,41,30,23,14,4,25,39,64.1,14,20,6,14,38,79,63,1,Matches
1690,Omar Mascarell,ESP,"MF,DF",Elche,La Liga,29,1993,27.2,53,26,32,19,2,31,64,48.4,33,51,19,32,45,98,54,1,Matches
1691,Adam Masina,MAR,DF,Udinese,Serie A,28,1994,8.8,10,7,7,3,0,6,15,40.0,9,11,4,7,10,20,28,1,Matches
1692,Jordi Masip,ESP,GK,Valladolid,La Liga,33,1989,27.9,0,0,0,0,0,0,2,0.0,2,0,0,0,1,1,3,2,Matches
1693,Erhan Mašović,SRB,"DF,MF",Bochum,Bundesliga,23,1998,24.2,50,31,28,21,1,30,51,58.8,21,30,14,16,27,77,79,0,Matches
1694,Han-Noah Massengo,FRA,MF,Auxerre,Ligue 1,21,2001,12.4,27,15,10,15,2,7,16,43.8,9,12,3,9,14,41,7,0,Matches
1695,Yanis Massolin,FRA,MF,Clermont Foot,Ligue 1,19,2002,0.7,2,1,1,0,1,0,1,0.0,1,1,0,1,2,4,0,0,Matches
1696,Jaime Mata,ESP,"FW,MF",Getafe,La Liga,33,1988,4.9,13,10,4,5,4,7,22,31.8,15,7,2,5,3,16,6,0,Matches
1697,Pape Matar Sarr,SEN,"MF,FW",Tottenham,Premier League,19,2002,2.4,7,6,4,2,1,4,8,50.0,4,3,2,1,6,13,6,0,Matches
1698,Eliot Matazo,BEL,MF,Monaco,Ligue 1,20,2002,13.1,26,12,11,13,2,11,26,42.3,15,18,4,14,15,41,11,1,Matches
1699,Jean-Philippe Mateta,FRA,FW,Crystal Palace,Premier League,25,1997,8.6,7,1,2,4,1,1,3,33.3,2,3,1,2,3,10,18,0,Matches
1700,Nemanja Matić,SRB,MF,Roma,Serie A,33,1988,20.6,47,27,24,19,4,19,33,57.6,14,27,7,20,25,72,21,1,Matches
1701,Joël Matip,CMR,DF,Liverpool,Premier League,30,1991,12.1,14,8,12,2,0,11,23,47.8,12,8,3,5,21,35,45,3,Matches
1702,Henning Matriciani,GER,DF,Schalke 04,Bundesliga,22,2000,20.7,43,23,28,12,3,26,60,43.3,34,28,11,17,23,66,57,1,Matches
1703,Chrislain Matsima,FRA,"DF,MF",Lorient,Ligue 1,20,2002,2.5,0,0,0,0,0,0,0,0.0,0,3,3,0,2,2,7,0,Matches
1704,Chrislain Matsima,FRA,DF,Monaco,Ligue 1,20,2002,5.0,11,6,7,2,2,4,7,57.1,3,5,5,0,9,20,16,0,Matches
1705,Jean Mattéo Bahoya,FRA,"FW,MF",Angers,Ligue 1,17,2005,3.0,7,3,1,3,3,4,7,57.1,3,4,0,4,0,7,0,0,Matches
1706,Azor Matusiwa,NED,MF,Reims,Ligue 1,24,1998,27.6,66,41,30,29,7,36,61,59.0,25,37,11,26,46,112,52,0,Matches
1707,Neal Maupay,FRA,FW,Everton,Premier League,25,1996,12.4,11,5,3,4,4,2,4,50.0,2,8,0,8,5,16,0,0,Matches
1708,Aïman Maurer,MAR,MF,Clermont Foot,Ligue 1,17,2004,5.6,2,1,1,1,0,1,10,10.0,9,1,0,1,3,5,5,0,Matches
1709,Stephy Mavididi,ENG,FW,Montpellier,Ligue 1,24,1998,14.3,24,19,12,8,4,13,27,48.1,14,21,1,20,4,28,10,0,Matches
1710,Konstantinos Mavropanos,GRE,DF,Stuttgart,Bundesliga,24,1997,25.4,50,27,32,15,3,28,38,73.7,10,39,18,21,63,113,99,0,Matches
1711,Christian Mawissa,FRA,DF,Toulouse,Ligue 1,17,2005,1.1,2,0,1,1,0,1,3,33.3,2,0,0,0,3,5,1,0,Matches
1712,Philipp Max,GER,DF,Eint Frankfurt,Bundesliga,28,1993,7.7,12,9,4,7,1,5,16,31.3,11,10,2,8,3,15,11,0,Matches
1713,Eric Maxim Choupo-Moting,CMR,FW,Bayern Munich,Bundesliga,33,1989,12.4,10,7,2,6,2,1,2,50.0,1,8,0,8,0,10,5,0,Matches
1714,Luís Maximiano,POR,GK,Lazio,Serie A,23,1999,0.1,0,0,0,0,0,0,0,0.0,0,0,0,0,0,0,0,0,Matches
1715,Keke Maximilian Topp,GER,FW,Schalke 04,Bundesliga,18,2004,0.2,0,0,0,0,0,0,0,0.0,0,0,0,0,1,1,0,0,Matches
1716,Fernand Mayembo,CGO,DF,Ajaccio,Ligue 1,26,1996,7.9,8,5,6,2,0,4,9,44.4,5,2,0,2,11,19,36,0,Matches
1717,Borja Mayoral,ESP,FW,Getafe,La Liga,25,1997,30.7,9,4,7,2,0,5,31,16.1,26,18,0,18,3,12,10,0,Matches
1718,Ibrahim Maza,GER,"MF,FW",Hertha BSC,Bundesliga,16,2005,0.8,1,1,1,0,0,0,1,0.0,1,2,0,2,0,1,1,0,Matches
1719,Derek Mazou-Sacko,FRA,MF,Troyes,Ligue 1,17,2004,0.2,0,0,0,0,0,0,1,0.0,1,1,0,1,1,1,1,0,Matches
1720,Noussair Mazraoui,MAR,DF,Bayern Munich,Bundesliga,24,1997,11.9,29,21,9,9,11,15,24,62.5,9,13,2,11,10,39,25,0,Matches
1721,Pasquale Mazzocchi,ITA,DF,Salernitana,Serie A,27,1995,21.8,32,18,21,5,6,17,37,45.9,20,10,2,8,10,42,37,2,Matches
1722,Kevin Mbabu,SUI,"DF,FW",Fulham,Premier League,27,1995,1.6,3,2,2,1,0,1,3,33.3,2,2,0,2,3,6,3,0,Matches
1723,Noah Mbamba,BEL,MF,Leverkusen,Bundesliga,17,2005,0.0,0,0,0,0,0,0,0,0.0,0,0,0,0,0,0,0,0,Matches
1724,Kylian Mbappé,FRA,FW,Paris S-G,Ligue 1,23,1998,31.3,10,4,0,5,5,5,16,31.3,11,5,0,5,5,15,6,0,Matches
1725,Mamadou Mbaye,SEN,DF,Cádiz,La Liga,24,1998,8.4,10,7,7,3,0,6,8,75.0,2,10,8,2,7,17,50,1,Matches
1726,Chancel Mbemba,COD,DF,Marseille,Ligue 1,27,1994,31.7,43,26,24,17,2,22,31,71.0,9,25,12,13,42,85,89,0,Matches
1727,Bryan Mbeumo,CMR,FW,Brentford,Premier League,22,1999,32.3,26,18,5,13,8,8,42,19.0,34,24,1,23,13,39,21,0,Matches
1728,Jason Mbock,FRA,"MF,FW",Angers,Ligue 1,22,1999,0.3,0,0,0,0,0,0,0,0.0,0,0,0,0,0,0,0,0,Matches
1729,Jean-Manuel Mbom,GER,MF,Werder Bremen,Bundesliga,22,2000,0.1,0,0,0,0,0,0,1,0.0,1,0,0,0,0,0,0,0,Matches
1730,Nathanael Mbuku,FRA,"FW,MF",Reims,Ligue 1,20,2002,0.7,2,1,2,0,0,2,2,100.0,0,0,0,0,0,2,0,0,Matches
1731,Nathanael Mbuku,FRA,"MF,FW",Augsburg,Bundesliga,20,2002,0.4,1,0,0,1,0,0,0,0.0,0,0,0,0,0,1,0,0,Matches
1732,James McArthur,SCO,MF,Crystal Palace,Premier League,34,1987,0.6,1,1,1,0,0,1,1,100.0,0,2,1,1,1,2,2,0,Matches
1733,Alex McCarthy,ENG,GK,Southampton,Premier League,32,1989,6.0,0,0,0,0,0,0,1,0.0,1,0,0,0,1,1,3,1,Matches
1734,John McGinn,SCO,"MF,FW",Aston Villa,Premier League,27,1994,29.9,66,36,27,29,10,34,71,47.9,37,43,4,39,24,90,19,0,Matches
1735,Scott McKenna,SCO,DF,Nott'ham Forest,Premier League,25,1996,17.5,12,7,7,3,2,6,10,60.0,4,20,14,6,12,24,85,1,Matches
1736,Weston McKennie,USA,MF,Leeds United,Premier League,23,1998,16.0,30,13,5,18,7,10,29,34.5,19,22,3,19,22,52,26,0,Matches
1737,Weston McKennie,USA,"MF,DF",Juventus,Serie A,23,1998,11.7,14,5,3,9,2,5,8,62.5,3,15,4,11,11,25,15,1,Matches
1738,Dwight McNeil,ENG,"FW,MF",Everton,Premier League,22,1999,27.8,64,41,35,14,15,27,62,43.5,35,46,7,39,31,95,41,0,Matches
1739,Scott McTominay,SCO,MF,Manchester Utd,Premier League,25,1996,12.9,32,19,16,10,6,13,22,59.1,9,15,6,9,14,46,45,0,Matches
1740,Gary Medel,CHI,"MF,DF",Bologna,Serie A,34,1987,16.4,25,15,16,7,2,9,16,56.3,7,17,10,7,28,53,34,0,Matches
1741,Facundo Medina,ARG,DF,Lens,Ligue 1,23,1999,30.9,31,20,16,15,0,13,35,37.1,22,25,9,16,26,57,62,1,Matches
1742,Fernando Medrano,ESP,DF,Celta Vigo,La Liga,22,2000,0.1,2,1,2,0,0,1,1,100.0,0,0,0,0,1,3,1,0,Matches
1743,Ben Mee,ENG,DF,Brentford,Premier League,32,1989,36.3,45,24,28,13,4,20,37,54.1,17,54,42,12,48,93,122,1,Matches
1744,Bamo Meïté,CIV,DF,Lorient,Ligue 1,21,2001,16.7,18,8,13,4,1,7,16,43.8,9,33,23,10,16,34,70,0,Matches
1745,Soualiho Meïté,FRA,MF,Cremonese,Serie A,28,1994,26.3,47,31,25,15,7,22,46,47.8,24,27,6,21,27,74,36,0,Matches
1746,Farid El Melali,ALG,"DF,FW",Angers,Ligue 1,25,1997,9.0,21,12,7,12,2,11,22,50.0,11,16,0,16,8,29,7,0,Matches
1747,Gonzalo Melero,ESP,MF,Almería,La Liga,28,1994,20.6,32,16,9,18,5,11,39,28.2,28,23,2,21,7,39,19,1,Matches
1748,Birger Meling,NOR,DF,Rennes,Ligue 1,27,1994,13.4,24,15,9,12,3,12,25,48.0,13,18,2,16,23,47,26,0,Matches
1749,Memphis,NED,FW,Barcelona,La Liga,28,1994,1.3,1,1,1,0,0,0,1,0.0,1,0,0,0,0,1,0,0,Matches
1750,Memphis,NED,FW,Atlético Madrid,La Liga,28,1994,3.0,1,0,0,0,1,0,1,0.0,1,0,0,0,0,1,0,0,Matches
1751,Houboulang Mendes,GNB,DF,Almería,La Liga,24,1998,9.8,19,11,16,3,0,11,27,40.7,16,12,2,10,7,26,23,1,Matches
1752,Nuno Mendes,POR,DF,Paris S-G,Ligue 1,20,2002,17.2,45,30,29,12,4,30,41,73.2,11,19,3,16,17,62,18,0,Matches
1753,Pedro Mendes,POR,DF,Montpellier,Ligue 1,31,1990,0.1,0,0,0,0,0,0,0,0.0,0,0,0,0,0,0,0,1,Matches
1754,Thiago Mendes,BRA,"MF,DF",Lyon,Ligue 1,30,1992,22.9,48,27,24,21,3,30,40,75.0,10,28,8,20,47,95,51,4,Matches
1755,Brais Méndez,ESP,MF,Real Sociedad,La Liga,25,1997,26.7,58,34,18,30,10,24,64,37.5,40,27,3,24,12,70,14,1,Matches
1756,Diego Méndez,ESP,MF,Rayo Vallecano,La Liga,18,2003,0.0,0,0,0,0,0,0,0,0.0,0,0,0,0,1,1,0,0,Matches
1757,Antoine Mendy,FRA,DF,Nice,Ligue 1,18,2004,5.8,22,13,16,5,1,9,15,60.0,6,6,1,5,2,24,16,0,Matches
1758,Arial Mendy,SEN,DF,Clermont Foot,Ligue 1,27,1994,2.5,4,2,3,0,1,2,2,100.0,0,2,0,2,4,8,4,0,Matches
1759,Batista Mendy,FRA,"MF,DF",Angers,Ligue 1,22,2000,31.8,70,30,34,28,8,37,53,69.8,16,38,6,32,21,91,29,2,Matches
1760,Edouard Mendy,SEN,GK,Chelsea,Premier League,30,1992,9.5,0,0,0,0,0,0,0,0.0,0,0,0,0,0,0,3,3,Matches
1761,Ferland Mendy,FRA,DF,Real Madrid,La Liga,27,1995,15.0,21,12,14,6,1,12,20,60.0,8,7,2,5,14,35,16,0,Matches
1762,Nampalys Mendy,SEN,MF,Leicester City,Premier League,30,1992,8.4,13,9,7,6,0,8,15,53.3,7,20,4,16,13,26,2,0,Matches
1763,Gideon Mensah,GHA,DF,Auxerre,Ligue 1,24,1998,25.1,80,44,43,32,5,44,77,57.1,33,33,10,23,38,118,41,0,Matches
1764,Chris Mepham,WAL,DF,Bournemouth,Premier League,24,1997,24.4,45,22,37,8,0,19,30,63.3,11,40,27,13,30,75,152,0,Matches
1765,Jorge Meré,ESP,DF,Cádiz,La Liga,25,1997,6.7,11,7,9,2,0,5,8,62.5,3,9,6,3,6,17,32,0,Matches
1766,Alex Meret,ITA,GK,Napoli,Serie A,25,1997,34.0,0,0,0,0,0,0,0,0.0,0,0,0,0,0,0,6,1,Matches
1767,Mikel Merino,ESP,MF,Real Sociedad,La Liga,26,1996,27.7,77,49,28,33,16,31,62,50.0,31,38,8,30,20,97,51,1,Matches
1768,Quentin Merlin,FRA,DF,Nantes,Ligue 1,20,2002,19.9,31,19,19,8,4,18,38,47.4,20,27,4,23,24,55,30,0,Matches
1769,Yıldırım Mert Çetin,TUR,DF,Lecce,Serie A,25,1997,0.2,1,0,1,0,0,0,0,0.0,0,0,0,0,1,2,1,0,Matches
1770,Roque Mesa,ESP,MF,Valladolid,La Liga,33,1989,18.0,27,15,16,10,1,12,38,31.6,26,16,4,12,13,40,18,0,Matches
1771,Illan Meslier,FRA,GK,Leeds United,Premier League,22,2000,34.0,2,1,2,0,0,2,4,50.0,2,0,0,0,1,3,30,3,Matches
1772,Lionel Messi,ARG,"FW,MF",Paris S-G,Ligue 1,35,1987,31.5,26,18,1,13,12,11,27,40.7,16,11,0,11,2,28,0,0,Matches
1773,Junior Messias,BRA,"FW,DF",Milan,Serie A,31,1991,16.6,24,18,9,9,6,5,19,26.3,14,20,4,16,7,31,28,0,Matches
1774,Amine Messoussa,FRA,FW,Lille,Ligue 1,17,2004,0.0,0,0,0,0,0,0,0,0.0,0,0,0,0,0,0,0,0,Matches
1775,Thomas Meunier,BEL,DF,Dortmund,Bundesliga,30,1991,6.5,16,7,8,5,3,10,17,58.8,7,7,2,5,9,25,16,0,Matches
1776,Alexander Meyer,GER,GK,Dortmund,Bundesliga,31,1991,7.0,0,0,0,0,0,0,1,0.0,1,0,0,0,0,0,1,0,Matches
1777,Sven Michel,GER,"FW,MF",Union Berlin,Bundesliga,32,1990,5.5,9,5,1,5,3,4,8,50.0,4,5,1,4,0,9,4,0,Matches
1778,Alex Mighten,ENG,FW,Nott'ham Forest,Premier League,20,2002,0.1,0,0,0,0,0,0,1,0.0,1,0,0,0,0,0,0,0,Matches
1779,Tommaso Milanese,ITA,MF,Cremonese,Serie A,20,2002,0.3,0,0,0,0,0,0,0,0.0,0,1,1,0,0,0,0,0,Matches
1780,Nikola Milenković,SRB,DF,Fiorentina,Serie A,24,1997,23.7,40,25,20,17,3,18,27,66.7,9,27,14,13,22,62,72,0,Matches
1781,Lewis Miley,ENG,MF,Newcastle Utd,Premier League,16,2006,0.2,0,0,0,0,0,0,0,0.0,0,1,0,1,0,0,0,0,Matches
1782,Arkadiusz Milik,POL,FW,Juventus,Serie A,28,1994,17.6,12,8,2,8,2,2,8,25.0,6,10,1,9,1,13,14,0,Matches
1783,Arkadiusz Milik,POL,FW,Marseille,Ligue 1,28,1994,1.4,1,1,0,0,1,0,1,0.0,1,0,0,0,0,1,2,0,Matches
1784,Sergej Milinković-Savić,SRB,MF,Lazio,Serie A,27,1995,33.6,58,35,22,23,13,24,67,35.8,43,50,12,38,28,86,49,0,Matches
1785,Vanja Milinković-Savić,SRB,GK,Torino,Serie A,25,1997,38.0,2,1,2,0,0,2,2,100.0,0,0,0,0,1,3,19,1,Matches
1786,Éder Militão,BRA,DF,Real Madrid,La Liga,24,1998,30.0,46,32,25,18,3,26,33,78.8,7,67,39,28,42,88,104,2,Matches
1787,Luka Milivojević,SRB,MF,Crystal Palace,Premier League,31,1991,5.7,13,7,7,4,2,7,10,70.0,3,13,4,9,12,25,10,0,Matches
1788,Luis Milla,ESP,MF,Getafe,La Liga,27,1994,20.6,48,30,21,18,9,19,44,43.2,25,13,1,12,32,80,25,1,Matches
1789,Pere Milla,ESP,"FW,MF",Elche,La Liga,29,1992,20.5,31,20,18,8,5,14,41,34.1,27,18,3,15,9,40,19,1,Matches
1790,Enzo Millot,FRA,MF,Stuttgart,Bundesliga,20,2002,9.9,23,16,9,10,4,12,19,63.2,7,20,3,17,12,35,7,0,Matches
1791,James Milner,ENG,"MF,DF",Liverpool,Premier League,36,1986,10.1,26,16,11,11,4,15,34,44.1,19,14,2,12,12,38,15,0,Matches
1792,Marko Milovanović,SRB,FW,Almería,La Liga,18,2003,0.2,0,0,0,0,0,0,0,0.0,0,0,0,0,0,0,0,0,Matches
1793,Kim Min-jae,KOR,DF,Napoli,Serie A,25,1996,33.9,55,30,32,22,1,25,29,86.2,4,36,26,10,41,96,123,1,Matches
1794,Yerry Mina,COL,DF,Everton,Premier League,27,1994,6.6,15,8,9,6,0,9,11,81.8,2,7,4,3,6,21,28,0,Matches
1795,Takumi Minamino,JPN,"MF,FW",Monaco,Ligue 1,27,1995,8.0,15,8,5,7,3,7,35,20.0,28,14,0,14,6,21,4,0,Matches
1796,Tyrone Mings,ENG,DF,Aston Villa,Premier League,29,1993,35.0,15,7,10,5,0,9,20,45.0,11,40,21,19,54,69,163,2,Matches
1797,Óscar Mingueza,ESP,DF,Celta Vigo,La Liga,23,1999,14.3,37,21,27,9,1,25,32,78.1,7,10,4,6,12,49,25,0,Matches
1798,Rafa Mir,ESP,FW,Sevilla,La Liga,25,1997,14.4,8,2,2,4,2,2,5,40.0,3,5,1,4,4,12,11,0,Matches
1799,Aleksei Miranchuk,RUS,MF,Torino,Serie A,26,1995,23.2,11,5,3,4,4,3,11,27.3,8,11,0,11,2,13,5,0,Matches
1800,Juan Miranda,ESP,DF,Betis,La Liga,22,2000,16.4,23,16,16,6,1,14,29,48.3,15,20,7,13,20,43,63,0,Matches
1801,Antonio Mirante,ITA,GK,Milan,Serie A,39,1983,0.0,0,0,0,0,0,0,0,0.0,0,0,0,0,0,0,0,0,Matches
1802,Fabio Miretti,ITA,"MF,FW",Juventus,Serie A,18,2003,13.7,24,11,15,6,3,12,29,41.4,17,20,1,19,4,28,11,0,Matches
1803,Filippo Missori,ITA,DF,Roma,Serie A,18,2004,2.0,4,3,3,0,1,3,6,50.0,3,0,0,0,3,7,5,0,Matches
1804,Tyrick Mitchell,ENG,DF,Crystal Palace,Premier League,22,1999,32.1,71,49,43,23,5,30,53,56.6,23,48,11,37,42,113,78,0,Matches
1805,Kaoru Mitoma,JPN,"FW,MF",Brighton,Premier League,25,1997,25.8,44,27,15,16,13,20,41,48.8,21,25,0,25,17,61,10,0,Matches
1806,Aleksandar Mitrović,SRB,FW,Fulham,Premier League,27,1994,22.3,14,7,8,4,2,5,12,41.7,7,22,5,17,3,17,20,1,Matches
1807,Stefan Mitrović,SRB,DF,Getafe,La Liga,32,1990,18.7,14,6,12,2,0,7,11,63.6,4,12,10,2,17,31,90,2,Matches
1808,Maximilian Mittelstädt,GER,"DF,MF",Hertha BSC,Bundesliga,25,1997,9.4,39,20,31,6,2,17,39,43.6,22,13,2,11,26,65,27,0,Matches
1809,Henrikh Mkhitaryan,ARM,MF,Inter,Serie A,33,1989,22.1,41,26,13,22,6,14,41,34.1,27,27,4,23,21,62,18,0,Matches
1810,Anthony Modeste,FRA,FW,Dortmund,Bundesliga,34,1988,9.0,4,4,2,0,2,2,5,40.0,3,7,0,7,2,6,22,0,Matches
1811,Luka Modrić,CRO,MF,Real Madrid,La Liga,36,1985,19.4,19,9,6,6,7,10,25,40.0,15,15,5,10,10,29,7,0,Matches
1812,Terem Moffi,NGA,FW,Nice,Ligue 1,23,1999,14.8,12,6,0,6,6,2,12,16.7,10,3,0,3,2,14,5,0,Matches
1813,Terem Moffi,NGA,FW,Lorient,Ligue 1,23,1999,15.4,8,5,1,4,3,3,5,60.0,2,11,3,8,3,11,10,0,Matches
1814,Mostafa Mohamed,EGY,FW,Nantes,Ligue 1,24,1997,21.5,18,13,5,7,6,9,20,45.0,11,23,1,22,10,28,33,0,Matches
1815,Tobias Mohr,GER,"DF,MF",Schalke 04,Bundesliga,26,1995,9.3,8,5,3,5,0,2,7,28.6,5,14,5,9,8,16,19,0,Matches
1816,Johan Mojica,COL,DF,Villarreal,La Liga,29,1992,7.1,13,9,9,3,1,5,9,55.6,4,8,3,5,4,17,14,1,Matches
1817,Johan Mojica,COL,"DF,MF",Elche,La Liga,29,1992,3.0,6,3,5,1,0,2,3,66.7,1,3,2,1,4,10,5,0,Matches
1818,Clinton Mola,ENG,DF,Stuttgart,Bundesliga,21,2001,0.2,3,1,2,1,0,1,1,100.0,0,1,1,0,1,4,2,0,Matches
1819,Nahuel Molina,ARG,DF,Atlético Madrid,La Liga,24,1998,31.9,69,43,38,18,13,39,91,42.9,52,38,7,31,18,87,63,1,Matches
1820,Salvatore Molina,ITA,DF,Monza,Serie A,30,1992,2.5,6,5,2,4,0,4,5,80.0,1,4,2,2,1,7,2,0,Matches
1821,Florent Mollet,FRA,MF,Nantes,Ligue 1,30,1991,12.1,14,6,5,4,5,7,24,29.2,17,12,1,11,10,24,11,0,Matches
1822,Florent Mollet,FRA,MF,Schalke 04,Bundesliga,30,1991,4.6,4,1,0,4,0,2,7,28.6,5,7,1,6,1,5,1,0,Matches
1823,Jon Moncayola,ESP,"MF,DF",Osasuna,La Liga,24,1998,27.2,55,39,24,22,9,30,76,39.5,46,37,5,32,17,72,32,2,Matches
1824,Monchu,ESP,MF,Valladolid,La Liga,22,1999,22.6,50,29,20,21,9,19,46,41.3,27,28,11,17,18,68,22,1,Matches
1825,César Montes,MEX,DF,Espanyol,La Liga,25,1997,17.7,17,9,10,7,0,10,18,55.6,8,19,12,7,14,31,101,0,Matches
1826,Daniele Montevago,ITA,FW,Sampdoria,Serie A,19,2003,2.6,1,0,0,0,1,0,1,0.0,1,2,1,1,0,1,1,0,Matches
1827,Gonzalo Montiel,ARG,DF,Sevilla,La Liga,25,1997,16.9,26,15,12,14,0,15,29,51.7,14,25,7,18,19,45,38,0,Matches
1828,Lorenzo Montipò,ITA,GK,Hellas Verona,Serie A,26,1996,37.0,1,0,1,0,0,0,3,0.0,3,1,0,1,0,1,26,3,Matches
1829,Martín Montoya,ESP,DF,Betis,La Liga,31,1991,5.0,13,8,9,4,0,10,12,83.3,2,6,1,5,9,22,14,1,Matches
1830,Kieffer Moore,WAL,FW,Bournemouth,Premier League,29,1992,14.2,14,11,2,9,3,5,16,31.3,11,12,5,7,1,15,26,0,Matches
1831,Andrew Moran,IRL,FW,Brighton,Premier League,18,2003,0.1,0,0,0,0,0,0,0,0.0,0,1,0,1,0,0,0,0,Matches
1832,Álvaro Morata,ESP,FW,Atlético Madrid,La Liga,29,1992,21.1,16,11,4,8,4,3,8,37.5,5,11,3,8,0,16,23,0,Matches
1833,Jon Morcillo,ESP,"FW,MF",Athletic Club,La Liga,23,1998,0.8,1,0,1,0,0,0,1,0.0,1,0,0,0,1,2,0,0,Matches
1834,Alberto Moreno,ESP,DF,Villarreal,La Liga,30,1992,14.4,23,12,10,10,3,11,24,45.8,13,12,1,11,23,46,26,0,Matches
1835,Álex Moreno,ESP,DF,Aston Villa,Premier League,29,1993,14.8,23,14,15,5,3,13,36,36.1,23,18,3,15,7,30,37,2,Matches
1836,Álex Moreno,ESP,DF,Betis,La Liga,29,1993,15.0,29,22,19,10,0,18,36,50.0,18,17,4,13,17,46,39,0,Matches
1837,Diego Moreno,ESP,DF,Osasuna,La Liga,21,2001,7.1,4,4,2,2,0,3,8,37.5,5,7,4,3,5,9,21,0,Matches
1838,Gerard Moreno,ESP,FW,Villarreal,La Liga,30,1992,13.7,11,6,0,6,5,3,6,50.0,3,6,2,4,5,16,10,0,Matches
1839,Marlos Moreno,COL,"MF,DF",Troyes,Ligue 1,25,1996,0.1,2,2,2,0,0,2,3,66.7,1,1,1,0,0,2,0,0,Matches
1840,Tete Morente,ESP,"MF,DF",Elche,La Liga,25,1996,23.0,33,21,18,13,2,15,36,41.7,21,23,3,20,25,58,28,0,Matches
1841,Ilaix Moriba,GUI,MF,Valencia,La Liga,19,2003,11.2,35,16,14,17,4,14,24,58.3,10,11,1,10,4,39,12,0,Matches
1842,Manu Morlanes,ESP,MF,Villarreal,La Liga,23,1999,1.8,3,2,2,1,0,3,3,100.0,0,3,2,1,1,4,2,0,Matches
1843,Manu Morlanes,ESP,MF,Mallorca,La Liga,23,1999,7.8,22,9,12,8,2,13,24,54.2,11,10,5,5,5,27,9,0,Matches
1844,Nikola Moro,CRO,MF,Bologna,Serie A,24,1998,13.6,32,21,11,15,6,14,36,38.9,22,15,2,13,8,40,18,0,Matches
1845,Loren Morón,ESP,FW,Betis,La Liga,28,1993,0.2,2,2,0,1,1,0,0,0.0,0,0,0,0,0,2,1,0,Matches
1846,Cristhian Mosquera,COL,DF,Valencia,La Liga,18,2004,1.6,4,2,3,1,0,4,5,80.0,1,1,0,1,1,5,5,0,Matches
1847,Dany Mota,POR,"FW,MF",Monza,Serie A,24,1998,21.2,8,7,1,3,4,2,10,20.0,8,5,1,4,6,14,25,0,Matches
1848,Lebo Mothiba,RSA,"FW,MF",Strasbourg,Ligue 1,26,1996,4.8,1,0,1,0,0,0,1,0.0,1,6,1,5,0,1,4,0,Matches
1849,Youssoufa Moukoko,GER,FW,Dortmund,Bundesliga,17,2004,12.7,13,7,3,6,4,3,6,50.0,3,9,0,9,2,15,1,0,Matches
1850,Steve Mounié,BEN,FW,Brest,Ligue 1,27,1994,18.4,13,5,1,7,5,5,14,35.7,9,18,7,11,3,16,20,0,Matches
1851,Mason Mount,ENG,"MF,FW",Chelsea,Premier League,23,1999,18.3,33,19,6,16,11,14,27,51.9,13,24,6,18,8,41,9,0,Matches
1852,Lucas Moura,BRA,"MF,DF",Tottenham,Premier League,29,1992,1.7,8,5,1,3,4,1,4,25.0,3,0,0,0,2,10,1,1,Matches
1853,Bevic Moussiti-Oko,CGO,FW,Ajaccio,Ligue 1,27,1995,7.8,3,1,1,1,1,1,2,50.0,1,5,3,2,2,5,8,0,Matches
1854,João Moutinho,POR,MF,Wolves,Premier League,35,1986,19.8,51,30,24,21,6,19,46,41.3,27,22,6,16,18,69,20,0,Matches
1855,João Moutinho,POR,"DF,FW",Spezia,Serie A,24,1998,0.6,7,1,5,1,1,3,4,75.0,1,1,1,0,0,7,0,0,Matches
1856,Samuel Moutoussamy,COD,MF,Nantes,Ligue 1,25,1996,26.7,64,34,27,28,9,26,76,34.2,50,23,2,21,24,88,15,0,Matches
1857,Divin Mubama,ENG,FW,West Ham,Premier League,17,2004,0.4,1,1,1,0,0,0,0,0.0,0,0,0,0,0,1,0,0,Matches
1858,Mykhailo Mudryk,UKR,"FW,MF",Chelsea,Premier League,21,2001,7.3,11,9,2,4,5,4,13,30.8,9,7,1,6,0,11,3,0,Matches
1859,François Mughe,CMR,MF,Marseille,Ligue 1,18,2004,0.1,0,0,0,0,0,0,0,0.0,0,0,0,0,0,0,0,0,Matches
1860,Nordi Mukiele,FRA,DF,Paris S-G,Ligue 1,24,1997,12.6,31,23,16,6,9,19,29,65.5,10,22,9,13,14,45,16,0,Matches
1861,Mert Müldür,TUR,"FW,DF",Sassuolo,Serie A,23,1999,0.1,0,0,0,0,0,0,0,0.0,0,0,0,0,0,0,0,0,Matches
1862,Florian Müller,GER,GK,Stuttgart,Bundesliga,24,1997,19.0,0,0,0,0,0,0,0,0.0,0,0,0,0,0,0,7,4,Matches
1863,Thomas Müller,GER,"FW,MF",Bayern Munich,Bundesliga,32,1989,18.5,21,12,5,9,7,6,16,37.5,10,19,3,16,4,25,16,0,Matches
1864,Abdul Mumin,GHA,DF,Rayo Vallecano,La Liga,24,1998,10.2,11,9,5,6,0,3,7,42.9,4,13,5,8,9,20,36,2,Matches
1865,Marshall Munetsi,ZIM,MF,Reims,Ligue 1,26,1996,30.0,58,27,13,31,14,20,48,41.7,28,37,11,26,26,84,41,1,Matches
1866,Iker Muniain,ESP,"MF,FW",Athletic Club,La Liga,29,1992,18.8,21,16,7,11,3,6,17,35.3,11,10,1,9,4,25,2,0,Matches
1867,Aihen Muñoz,ESP,DF,Real Sociedad,La Liga,24,1997,19.5,38,23,17,17,4,22,47,46.8,25,26,5,21,9,47,38,0,Matches
1868,Álvaro Muñoz,URU,FW,Real Madrid,La Liga,18,2004,0.9,2,1,1,0,1,1,1,100.0,0,0,0,0,0,2,1,0,Matches
1869,Iker Muñoz,ESP,MF,Osasuna,La Liga,19,2002,2.8,1,0,0,1,0,0,3,0.0,3,2,1,1,3,4,8,0,Matches
1870,Pablo Muñoz,ESP,MF,Rayo Vallecano,La Liga,18,2003,0.1,0,0,0,0,0,0,1,0.0,1,0,0,0,0,0,0,0,Matches
1871,Luis Muriel,COL,"FW,MF",Atalanta,Serie A,31,1991,11.9,9,6,2,3,4,5,16,31.3,11,9,0,9,2,11,2,0,Matches
1872,Jeison Murillo,COL,DF,Sampdoria,Serie A,30,1992,11.7,22,11,16,6,0,17,26,65.4,9,22,14,8,8,30,39,0,Matches
1873,Vedat Muriqi,KVX,FW,Mallorca,La Liga,28,1994,32.6,12,7,4,7,1,3,13,23.1,10,19,7,12,12,24,73,0,Matches
1874,Jacob Murphy,ENG,FW,Newcastle Utd,Premier League,27,1995,13.9,15,7,3,8,4,8,20,40.0,12,17,0,17,7,22,3,0,Matches
1875,Nicola Murru,ITA,DF,Sampdoria,Serie A,27,1994,8.7,24,14,15,8,1,7,13,53.8,6,17,7,10,10,34,21,0,Matches
1876,Yunus Musah,USA,MF,Valencia,La Liga,19,2002,23.4,48,35,17,23,8,20,30,66.7,10,20,1,19,11,59,16,2,Matches
1877,Jamal Musiala,GER,"MF,FW",Bayern Munich,Bundesliga,19,2003,24.4,34,23,9,16,9,13,35,37.1,22,30,3,27,19,53,3,0,Matches
1878,Juan Musso,ARG,GK,Atalanta,Serie A,28,1994,23.1,1,1,1,0,0,1,1,100.0,0,0,0,0,0,1,11,1,Matches
1879,Marlon Mustapha,AUT,"FW,MF",Mainz 05,Bundesliga,21,2001,0.8,2,2,0,2,0,0,0,0.0,0,4,0,4,0,2,0,0,Matches
1880,Yvon Mvogo,SUI,GK,Lorient,Ligue 1,28,1994,20.1,0,0,0,0,0,0,0,0.0,0,0,0,0,2,2,6,3,Matches
1881,Enock Mwepu,ZAM,"FW,MF",Brighton,Premier League,24,1998,2.4,10,5,1,6,3,3,4,75.0,1,3,1,2,1,11,1,0,Matches
1882,Francisco Mwepu,ZAM,FW,Cádiz,La Liga,22,2000,0.2,1,0,0,1,0,0,0,0.0,0,0,0,0,0,1,0,0,Matches
1883,Vitaliy Mykolenko,UKR,DF,Everton,Premier League,23,1999,29.5,58,34,36,19,3,28,51,54.9,23,50,16,34,46,104,99,0,Matches
1884,Joakim Mæhle,DEN,"DF,MF",Atalanta,Serie A,25,1997,24.5,32,18,12,7,13,22,39,56.4,17,29,6,23,24,56,26,0,Matches
1885,Obite N'Dicka,CIV,DF,Eint Frankfurt,Bundesliga,22,1999,29.9,25,18,10,11,4,18,32,56.3,14,47,19,28,31,56,150,0,Matches
1886,Nathan N'Goumou,FRA,FW,Toulouse,Ligue 1,22,2000,1.0,3,2,2,1,0,1,1,100.0,0,2,0,2,2,5,0,0,Matches
1887,Nathan N'Goumou,FRA,FW,M'Gladbach,Bundesliga,22,2000,7.7,11,5,5,5,1,7,13,53.8,6,9,0,9,1,12,4,0,Matches
1888,Stanley N'Soki,FRA,DF,Hoffenheim,Bundesliga,23,1999,14.3,22,13,14,7,1,12,22,54.5,10,22,5,17,24,46,34,0,Matches
1889,Herculano Nabian,POR,MF,Empoli,Serie A,18,2004,0.0,0,0,0,0,0,0,0,0.0,0,0,0,0,0,0,0,0,Matches
1890,Nacho,ESP,DF,Real Madrid,La Liga,32,1990,18.2,24,16,17,5,2,12,29,41.4,17,11,6,5,18,42,37,0,Matches
1891,Nikolas Nartey,DEN,"DF,MF",Stuttgart,Bundesliga,22,2000,5.3,11,6,7,3,1,5,9,55.6,4,9,0,9,4,15,12,0,Matches
1892,Juanjo Narváez,COL,"MF,FW",Valladolid,La Liga,27,1995,1.6,1,1,1,0,0,1,1,100.0,0,2,0,2,0,1,0,0,Matches
1893,Matija Nastasić,SRB,DF,Mallorca,La Liga,29,1993,10.1,10,8,7,1,2,3,6,50.0,3,11,4,7,18,28,43,1,Matches
1894,Roberto Navarro,ESP,"MF,FW",Real Sociedad,La Liga,20,2002,3.9,5,4,4,0,1,1,2,50.0,1,7,0,7,2,7,2,0,Matches
1895,Jesús Navas,ESP,"DF,FW",Sevilla,La Liga,36,1985,22.0,19,12,8,3,8,11,22,50.0,11,18,7,11,22,41,52,1,Matches
1896,Keylor Navas,CRC,GK,Nott'ham Forest,Premier League,35,1986,17.0,0,0,0,0,0,0,0,0.0,0,0,0,0,1,1,11,1,Matches
1897,Michel Ndary Adopo,FRA,"MF,DF",Torino,Serie A,22,2000,2.9,7,2,4,2,1,1,3,33.3,2,2,2,0,1,8,4,0,Matches
1898,Youssouf Ndayishimiye,BDI,"MF,DF",Nice,Ligue 1,23,1998,6.3,13,9,8,5,0,6,11,54.5,5,8,5,3,12,25,22,1,Matches
1899,Papa Ndiaga Yade,SEN,"DF,MF",Troyes,Ligue 1,22,2000,6.3,10,6,6,2,2,7,22,31.8,15,10,2,8,8,18,10,0,Matches
1900,Wilfred Ndidi,NGA,MF,Leicester City,Premier League,25,1996,18.7,61,42,34,24,3,17,43,39.5,26,32,14,18,38,99,48,3,Matches
1901,Tanguy Ndombele,FRA,MF,Napoli,Serie A,25,1996,9.0,14,8,4,8,2,4,7,57.1,3,10,1,9,7,21,7,1,Matches
1902,Álvaro Negredo,ESP,FW,Cádiz,La Liga,36,1985,8.4,5,4,1,2,2,2,2,100.0,0,4,1,3,0,5,8,0,Matches
1903,Reiss Nelson,ENG,FW,Arsenal,Premier League,22,1999,2.4,4,1,2,1,1,2,4,50.0,2,3,0,3,0,4,4,0,Matches
1904,Ilija Nestorovski,MKD,"FW,MF",Udinese,Serie A,32,1990,7.1,7,3,2,1,4,5,11,45.5,6,6,1,5,2,9,10,0,Matches
1905,Neto,BRA,GK,Bournemouth,Premier League,33,1989,26.5,3,1,3,0,0,3,3,100.0,0,0,0,0,0,3,10,3,Matches
1906,Pedro Neto,POR,"FW,MF",Wolves,Premier League,22,2000,10.7,11,6,4,2,5,7,17,41.2,10,5,1,4,4,15,4,0,Matches
1907,Luca Netz,GER,DF,M'Gladbach,Bundesliga,19,2003,7.8,25,13,19,3,3,19,32,59.4,13,5,1,4,6,31,27,0,Matches
1908,Manuel Neuer,GER,GK,Bayern Munich,Bundesliga,36,1986,12.0,0,0,0,0,0,0,0,0.0,0,0,0,0,0,0,4,1,Matches
1909,Florian Neuhaus,GER,MF,M'Gladbach,Bundesliga,25,1997,15.6,19,9,9,5,5,8,27,29.6,19,20,3,17,12,31,5,0,Matches
1910,Rúben Neves,POR,MF,Wolves,Premier League,25,1997,33.5,79,43,31,33,15,32,74,43.2,42,59,22,37,50,129,85,1,Matches
1911,Neymar,BRA,"MF,FW",Paris S-G,Ligue 1,30,1992,17.2,22,14,6,9,7,9,19,47.4,10,7,1,6,4,26,1,1,Matches
1912,Jessic Ngankam,GER,"FW,MF",Hertha BSC,Bundesliga,22,2000,9.2,14,9,7,4,3,6,14,42.9,8,6,1,5,1,15,4,0,Matches
1913,Cyril Ngonge,BEL,"MF,FW",Hellas Verona,Serie A,22,2000,8.3,7,3,2,2,3,3,11,27.3,8,7,0,7,6,13,4,0,Matches
1914,Moussa Niakhate,SEN,DF,Nott'ham Forest,Premier League,26,1996,12.9,18,9,15,3,0,11,22,50.0,11,18,8,10,19,37,60,0,Matches
1915,Ibrahima Niane,SEN,FW,Angers,Ligue 1,23,1999,12.6,6,2,1,4,1,1,6,16.7,5,8,2,6,1,7,9,0,Matches
1916,M'Baye Niang,SEN,FW,Auxerre,Ligue 1,27,1994,16.5,13,7,1,8,4,3,13,23.1,10,22,1,21,1,14,20,0,Matches
1917,Tanguy Nianzou,FRA,DF,Sevilla,La Liga,20,2002,15.2,20,15,10,9,1,8,11,72.7,3,8,5,3,16,36,44,3,Matches
1918,Rasmus Nicolaisen,DEN,DF,Toulouse,Ligue 1,25,1997,33.3,48,21,34,14,0,29,46,63.0,17,58,45,13,50,98,152,0,Matches
1919,Hans Nicolussi Caviglia,ITA,MF,Salernitana,Serie A,22,2000,6.5,15,6,5,8,2,9,15,60.0,6,9,0,9,7,22,7,1,Matches
1920,Florian Niederlechner,GER,"FW,MF",Augsburg,Bundesliga,31,1990,10.1,10,5,5,4,1,4,7,57.1,3,16,2,14,1,11,9,0,Matches
1921,Florian Niederlechner,GER,FW,Hertha BSC,Bundesliga,31,1990,8.7,9,7,2,4,3,2,8,25.0,6,7,0,7,3,12,10,0,Matches
1922,Saúl Ñíguez,ESP,"MF,DF",Atlético Madrid,La Liga,27,1994,12.2,42,27,18,18,6,22,37,59.5,15,27,5,22,15,57,29,0,Matches
1923,Dimitris Nikolaou,GRE,DF,Spezia,Serie A,23,1998,32.9,45,32,31,10,4,25,37,67.6,12,41,26,15,27,72,82,0,Matches
1924,Fernando Niño,ESP,"MF,FW",Villarreal,La Liga,21,2000,0.2,0,0,0,0,0,0,0,0.0,0,0,0,0,0,0,0,0,Matches
1925,Rasmus Nissen,DEN,DF,Leeds United,Premier League,25,1997,21.8,62,35,35,21,6,42,76,55.3,34,32,14,18,35,97,61,0,Matches
1926,Justin Njinmah,GER,FW,Dortmund,Bundesliga,21,2000,0.2,0,0,0,0,0,0,0,0.0,0,0,0,0,0,0,0,0,Matches
1927,Eddie Nketiah,ENG,FW,Arsenal,Premier League,23,1999,12.1,13,9,6,2,5,2,8,25.0,6,7,1,6,1,14,7,0,Matches
1928,Christopher Nkunku,FRA,"FW,MF",RB Leipzig,Bundesliga,24,1997,21.1,6,4,2,1,3,1,6,16.7,5,8,3,5,8,14,11,0,Matches
1929,Felix Nmecha,GER,MF,Wolfsburg,Bundesliga,21,2000,20.4,41,24,11,23,7,16,34,47.1,18,26,10,16,25,66,31,0,Matches
1930,Lukas Nmecha,GER,FW,Wolfsburg,Bundesliga,23,1998,10.0,5,3,0,2,3,3,3,100.0,0,5,1,4,3,8,4,0,Matches
1931,Arnaud Nordin,FRA,FW,Montpellier,Ligue 1,24,1998,26.7,26,14,10,12,4,12,28,42.9,16,19,1,18,14,40,7,0,Matches
1932,Riad Nouri,FRA,"MF,FW",Ajaccio,Ligue 1,37,1985,18.8,21,12,7,10,4,12,29,41.4,17,8,1,7,15,36,11,0,Matches
1933,Hugo Novoa,ESP,"DF,FW",RB Leipzig,Bundesliga,19,2003,2.0,8,2,1,3,4,4,7,57.1,3,4,0,4,1,9,0,0,Matches
1934,Samuel Ntanda,BEL,MF,Sampdoria,Serie A,17,2005,0.0,0,0,0,0,0,0,0,0.0,0,0,0,0,0,0,0,0,Matches
1935,Randy Ntekja,FRA,"FW,MF",Elche,La Liga,24,1997,8.1,15,10,7,6,2,2,11,18.2,9,15,3,12,4,19,9,0,Matches
1936,Randy Ntekja,FRA,"FW,MF",Rayo Vallecano,La Liga,24,1997,1.3,4,2,2,2,0,1,1,100.0,0,2,0,2,2,6,3,0,Matches
1937,Alexander Nübel,GER,GK,Monaco,Ligue 1,25,1996,38.0,0,0,0,0,0,0,1,0.0,1,0,0,0,1,1,10,3,Matches
1938,Matheus Nunes,POR,MF,Wolves,Premier League,23,1998,27.4,67,43,36,22,9,28,61,45.9,33,35,4,31,16,83,35,2,Matches
1939,Darwin Núñez,URU,FW,Liverpool,Premier League,23,1999,18.8,11,5,2,4,5,4,17,23.5,13,10,0,10,3,14,13,0,Matches
1940,Unai Núñez,ESP,DF,Celta Vigo,La Liga,25,1997,35.0,47,35,29,15,3,18,34,52.9,16,27,17,10,72,119,135,1,Matches
1941,Bram Nuytinck,NED,DF,Udinese,Serie A,32,1990,4.3,7,4,3,4,0,4,8,50.0,4,6,6,0,5,12,22,0,Matches
1942,Bram Nuytinck,NED,DF,Sampdoria,Serie A,32,1990,16.6,54,38,33,21,0,23,34,67.6,11,36,21,15,23,77,84,0,Matches
1943,Ethan Nwaneri,ENG,FW,Arsenal,Premier League,15,2007,0.0,0,0,0,0,0,0,0,0.0,0,1,0,1,0,0,0,0,Matches
1944,Gerzino Nyamsi,FRA,DF,Strasbourg,Ligue 1,25,1997,17.5,28,20,14,12,2,10,12,83.3,2,19,11,8,10,38,63,1,Matches
1945,Ørjan Nyland,NOR,GK,RB Leipzig,Bundesliga,31,1990,2.0,0,0,0,0,0,0,0,0.0,0,0,0,0,0,0,0,0,Matches
1946,M'Bala Nzola,ANG,FW,Spezia,Serie A,25,1996,29.5,12,5,0,6,6,3,9,33.3,6,20,6,14,7,19,21,0,Matches
1947,Christian Nørgaard,DEN,MF,Brentford,Premier League,28,1994,19.6,52,30,21,29,2,18,48,37.5,30,32,9,23,34,86,41,2,Matches
1948,Lewis O'Brien,ENG,MF,Nott'ham Forest,Premier League,23,1998,6.5,16,9,4,11,1,6,12,50.0,6,13,2,11,5,21,9,0,Matches
1949,Pedro Obiang,EQG,MF,Sassuolo,Serie A,30,1992,9.7,26,17,12,12,2,10,18,55.6,8,12,2,10,8,34,15,0,Matches
1950,Jan Oblak,SVN,GK,Atlético Madrid,La Liga,29,1993,27.7,0,0,0,0,0,0,0,0.0,0,0,0,0,1,1,8,0,Matches
1951,Brian Ocampo,URU,"MF,FW",Cádiz,La Liga,23,1999,12.4,18,15,12,5,1,8,21,38.1,13,13,0,13,3,21,3,0,Matches
1952,Lucas Ocampos,ARG,"FW,MF",Sevilla,La Liga,28,1994,12.9,22,14,9,9,4,8,31,25.8,23,17,2,15,8,30,5,0,Matches
1953,Guillermo Ochoa,MEX,GK,Salernitana,Serie A,37,1985,20.0,0,0,0,0,0,0,2,0.0,2,0,0,0,0,0,9,1,Matches
1954,Wilson Odobert,FRA,"MF,FW",Troyes,Ligue 1,17,2004,19.6,20,14,10,7,3,9,25,36.0,16,11,0,11,15,35,5,0,Matches
1955,Álvaro Odriozola,ESP,DF,Real Madrid,La Liga,26,1995,0.4,0,0,0,0,0,0,0,0.0,0,0,0,0,0,0,0,0,Matches
1956,Tim Oermann,GER,DF,Bochum,Bundesliga,18,2003,2.2,2,1,2,0,0,1,1,100.0,0,3,2,1,1,3,8,1,Matches
1957,Odeluga Offiah,ENG,DF,Brighton,Premier League,19,2002,0.3,1,1,1,0,0,0,2,0.0,2,0,0,0,0,1,1,0,Matches
1958,Angelo Ogbonna,ITA,DF,West Ham,Premier League,34,1988,13.7,11,4,7,4,0,5,10,50.0,5,11,7,4,17,28,74,1,Matches
1959,Florent Ogier,FRA,DF,Clermont Foot,Ligue 1,33,1989,18.9,33,16,20,12,1,22,39,56.4,17,22,13,9,18,51,64,1,Matches
1960,Marios Oikonomou,GRE,DF,Sampdoria,Serie A,29,1992,2.4,3,2,3,0,0,1,3,33.3,2,5,4,1,4,7,13,0,Matches
1961,David Okereke,NGA,"FW,MF",Cremonese,Serie A,24,1997,25.2,12,8,4,5,3,3,16,18.8,13,23,3,20,10,22,12,0,Matches
1962,Caleb Okoli,ITA,DF,Atalanta,Serie A,21,2001,10.7,21,17,14,6,1,10,25,40.0,15,10,5,5,30,51,44,3,Matches
1963,Olasagasti,ESP,"MF,DF",Real Sociedad,La Liga,21,2000,0.7,4,4,1,2,1,1,2,50.0,1,2,0,2,0,4,1,0,Matches
1964,Lucas Olaza,URU,DF,Valladolid,La Liga,28,1994,16.6,24,14,12,10,2,17,26,65.4,9,20,8,12,14,38,34,0,Matches
1965,Finn Ole Becker,GER,MF,Hoffenheim,Bundesliga,22,2000,5.7,10,2,4,6,0,4,7,57.1,3,4,0,4,5,15,8,0,Matches
1966,Mathias Olesen,LUX,MF,Köln,Bundesliga,21,2001,5.3,10,5,4,4,2,5,8,62.5,3,6,1,5,2,12,3,0,Matches
1967,Michael Olise,FRA,"FW,MF",Crystal Palace,Premier League,20,2001,30.5,58,34,28,26,4,25,60,41.7,35,46,1,45,26,84,17,0,Matches
1968,Brian Oliván,ESP,DF,Espanyol,La Liga,28,1994,26.7,47,27,30,12,5,17,26,65.4,9,26,6,20,22,69,67,0,Matches
1969,Lucas Oliveira Rosa,BRA,DF,Valladolid,La Liga,22,2000,10.3,39,18,23,10,6,12,20,60.0,8,12,2,10,15,54,24,0,Matches
1970,Mathías Olivera,URU,DF,Napoli,Serie A,24,1997,18.3,39,23,16,16,7,22,43,51.2,21,28,2,26,22,61,26,0,Matches
1971,Dani Olmo,ESP,"MF,FW",RB Leipzig,Bundesliga,24,1998,14.2,15,9,1,10,4,6,14,42.9,8,15,0,15,6,21,6,0,Matches
1972,Jan Olschowsky,GER,GK,M'Gladbach,Bundesliga,20,2001,4.0,0,0,0,0,0,0,1,0.0,1,1,0,1,0,0,1,0,Matches
1973,Robin Olsen,SWE,GK,Aston Villa,Premier League,32,1990,3.1,0,0,0,0,0,0,2,0.0,2,0,0,0,0,0,1,0,Matches
1974,Warmed Omari,FRA,DF,Rennes,Ligue 1,22,2000,15.1,20,11,14,6,0,14,28,50.0,14,13,7,6,17,37,43,1,Matches
1975,Jonas Omlin,SUI,GK,Montpellier,Ligue 1,28,1994,13.0,1,0,1,0,0,0,0,0.0,0,0,0,0,0,1,8,1,Matches
1976,Jonas Omlin,SUI,GK,M'Gladbach,Bundesliga,28,1994,14.3,1,1,1,0,0,1,3,33.3,2,1,0,1,0,1,9,1,Matches
1977,Ado Onaiwu,JPN,FW,Toulouse,Ligue 1,26,1995,12.0,11,6,4,4,3,5,13,38.5,8,5,1,4,2,13,5,0,Matches
1978,Amadou Onana,BEL,MF,Everton,Premier League,20,2001,27.6,72,43,24,42,6,30,42,71.4,12,25,6,19,37,109,39,0,Matches
1979,André Onana,CMR,GK,Inter,Serie A,26,1996,24.0,0,0,0,0,0,0,1,0.0,1,0,0,0,0,0,5,0,Matches
1980,Jean Onana,CMR,"MF,DF",Lens,Ligue 1,22,2000,9.0,28,17,8,17,3,10,22,45.5,12,15,5,10,18,46,20,0,Matches
1981,Karim Onisiwo,AUT,"FW,MF",Mainz 05,Bundesliga,30,1992,28.2,19,12,3,10,6,4,21,19.0,17,19,0,19,2,21,7,0,Matches
1982,Josh Onomah,ENG,MF,Fulham,Premier League,25,1997,0.2,1,0,1,0,0,0,0,0.0,0,1,0,1,0,1,0,0,Matches
1983,Paul Onuachu,NGA,FW,Southampton,Premier League,28,1994,4.5,3,2,1,1,1,1,3,33.3,2,4,1,3,0,3,4,0,Matches
1984,Frank Onyeka,NGA,MF,Brentford,Premier League,24,1998,9.4,19,14,11,7,1,10,25,40.0,15,16,3,13,10,29,16,0,Matches
1985,Loïs Openda,BEL,FW,Lens,Ligue 1,22,2000,28.0,11,9,2,6,3,2,13,15.4,11,9,0,9,2,13,6,0,Matches
1986,Willi Orban,HUN,DF,RB Leipzig,Bundesliga,29,1992,32.8,51,30,33,18,0,26,43,60.5,17,42,24,18,39,90,129,1,Matches
1987,Ivan Ordets,UKR,DF,Bochum,Bundesliga,30,1992,27.2,31,19,21,9,1,16,28,57.1,12,34,17,17,57,88,139,0,Matches
1988,Divock Origi,BEL,FW,Milan,Serie A,27,1995,11.4,10,5,4,3,3,5,10,50.0,5,6,2,4,0,10,13,0,Matches
1989,Aimar Oroz,ESP,"MF,FW",Osasuna,La Liga,20,2001,22.4,26,14,8,10,8,8,30,26.7,22,24,1,23,24,50,6,0,Matches
1990,Mislav Oršić,CRO,MF,Southampton,Premier League,29,1992,0.1,1,1,1,0,0,0,0,0.0,0,0,0,0,0,1,0,0,Matches
1991,Riccardo Orsolini,ITA,FW,Bologna,Serie A,25,1997,23.6,30,19,15,10,5,17,41,41.5,24,29,3,26,8,38,18,0,Matches
1992,Stefan Ortega,GER,GK,Manchester City,Premier League,29,1992,3.0,0,0,0,0,0,0,0,0.0,0,0,0,0,0,0,0,0,Matches
1993,Pedro Ortiz,ESP,MF,Sevilla,La Liga,21,2000,0.0,0,0,0,0,0,0,0,0.0,0,0,0,0,0,0,0,0,Matches
1994,Jordi Osei-Tutu,ENG,"DF,FW",Bochum,Bundesliga,23,1998,8.3,23,18,13,5,5,12,23,52.2,11,12,5,7,10,33,8,0,Matches
1995,Victor Osimhen,NGA,FW,Napoli,Serie A,23,1998,28.5,10,6,1,2,7,0,7,0.0,7,6,1,5,6,16,29,0,Matches
1996,Patrick Osterhage,GER,MF,Bochum,Bundesliga,22,2000,11.4,20,17,8,10,2,11,16,68.8,5,17,6,11,12,32,25,0,Matches
1997,Paulo Otávio,BRA,DF,Wolfsburg,Bundesliga,27,1994,22.7,72,46,46,17,9,44,66,66.7,22,42,6,36,30,102,70,1,Matches
1998,Dango Ouattara,BFA,"MF,FW",Bournemouth,Premier League,20,2002,13.8,28,15,20,6,2,13,32,40.6,19,20,3,17,13,41,29,1,Matches
1999,Dango Ouattara,BFA,"FW,MF",Lorient,Ligue 1,20,2002,17.2,41,26,20,11,10,15,28,53.6,13,24,6,18,19,60,21,0,Matches
2000,Remi Oudin,FRA,"FW,MF",Lecce,Serie A,25,1996,14.7,25,13,9,12,4,10,23,43.5,13,16,2,14,29,54,23,0,Matches
2001,Zinédine Ould Khaled,FRA,"MF,FW",Angers,Ligue 1,22,2000,0.6,1,1,0,1,0,0,1,0.0,1,0,0,0,2,3,0,0,Matches
2002,Azzedine Ounahi,MAR,"MF,FW",Marseille,Ligue 1,22,2000,1.3,2,1,1,1,0,0,2,0.0,2,1,0,1,0,2,0,0,Matches
2003,Azzedine Ounahi,MAR,"MF,FW",Angers,Ligue 1,22,2000,12.5,19,8,5,13,1,10,20,50.0,10,8,0,8,15,34,4,1,Matches
2004,Adam Ounas,ALG,FW,Napoli,Serie A,25,1996,0.2,0,0,0,0,0,0,0,0.0,0,0,0,0,1,1,0,0,Matches
2005,Adam Ounas,ALG,"FW,MF",Lille,Ligue 1,25,1996,11.8,20,11,4,10,6,8,13,61.5,5,16,0,16,7,27,5,0,Matches
2006,Thomas Ouwejan,NED,DF,Schalke 04,Bundesliga,25,1996,10.0,20,8,13,5,2,6,10,60.0,4,17,4,13,13,33,27,0,Matches
2007,Reece Oxford,ENG,DF,Augsburg,Bundesliga,23,1998,1.0,1,1,1,0,0,0,0,0.0,0,4,3,1,1,2,5,0,Matches
2008,Alex Oxlade-Chamberlain,ENG,"FW,MF",Liverpool,Premier League,28,1993,3.7,5,4,1,2,2,1,5,20.0,4,5,2,3,1,6,4,0,Matches
2009,Mikel Oyarzabal,ESP,"FW,MF",Real Sociedad,La Liga,25,1997,13.5,13,7,5,3,5,5,19,26.3,14,14,4,10,3,16,5,0,Matches
2010,Salih Özcan,TUR,MF,Dortmund,Bundesliga,24,1998,17.5,31,18,10,16,5,16,39,41.0,23,24,2,22,28,59,19,1,Matches
2011,Cenk Özkacar,TUR,DF,Valencia,La Liga,21,2000,15.2,27,20,17,10,0,14,19,73.7,5,14,2,12,12,39,47,4,Matches
2012,David Ozoh,ENG,FW,Crystal Palace,Premier League,17,2005,0.0,0,0,0,0,0,0,0,0.0,0,0,0,0,0,0,0,0,Matches
2013,Levin Öztunalı,GER,MF,Union Berlin,Bundesliga,26,1996,0.1,0,0,0,0,0,0,1,0.0,1,0,0,0,0,0,0,0,Matches
2014,Fernando Pacheco,ESP,GK,Almería,La Liga,30,1992,1.0,0,0,0,0,0,0,0,0.0,0,0,0,0,0,0,1,0,Matches
2015,Fernando Pacheco,ESP,GK,Espanyol,La Liga,30,1992,16.0,0,0,0,0,0,0,1,0.0,1,0,0,0,1,1,11,0,Matches
2016,Jon Pacheco,ESP,DF,Real Sociedad,La Liga,21,2001,13.3,16,10,10,6,0,6,10,60.0,4,9,6,3,12,28,37,1,Matches
2017,Gonçalo Paciência,POR,"FW,MF",Celta Vigo,La Liga,27,1994,7.4,8,5,0,5,3,2,7,28.6,5,9,1,8,0,8,4,0,Matches
2018,Simone Pafundi,ITA,"MF,FW",Udinese,Serie A,16,2006,0.9,8,5,1,5,2,2,4,50.0,2,0,0,0,1,9,0,0,Matches
2019,Exequiel Palacios,ARG,MF,Leverkusen,Bundesliga,23,1998,18.4,59,36,20,33,6,29,48,60.4,19,29,2,27,33,92,28,0,Matches
2020,Helibelton Palacios,COL,DF,Elche,La Liga,29,1993,21.3,38,20,21,15,2,19,26,73.1,7,26,12,14,20,58,55,0,Matches
2021,Ante Palaversa,CRO,MF,Troyes,Ligue 1,22,2000,0.3,1,1,1,0,0,0,0,0.0,0,0,0,0,1,2,0,0,Matches
2022,Isaac Palazón Camacho,ESP,"FW,MF",Rayo Vallecano,La Liga,27,1994,32.9,45,30,11,23,11,24,66,36.4,42,42,3,39,17,62,30,0,Matches
2023,João Palhinha,POR,MF,Fulham,Premier League,27,1995,34.5,147,83,58,65,24,71,134,53.0,63,48,5,43,46,193,61,2,Matches
2024,Nicolas Pallois,FRA,DF,Nantes,Ligue 1,34,1987,24.6,69,44,51,16,2,42,70,60.0,28,35,18,17,30,99,131,2,Matches
2025,Cole Palmer,ENG,"MF,FW",Manchester City,Premier League,20,2002,4.1,5,1,0,3,2,3,5,60.0,2,2,1,1,1,6,2,0,Matches
2026,Erik Palmer-Brown,USA,DF,Troyes,Ligue 1,25,1997,35.5,42,27,31,10,1,18,33,54.5,15,56,29,27,26,68,166,1,Matches
2027,Emerson Palmieri,ITA,DF,West Ham,Premier League,27,1994,14.7,26,14,9,15,2,12,24,50.0,12,17,4,13,15,41,36,0,Matches
2028,Miloš Pantović,SRB,MF,Union Berlin,Bundesliga,26,1996,2.3,4,2,4,0,0,3,5,60.0,2,3,0,3,0,4,5,0,Matches
2029,Flavio Paoletti,ITA,MF,Sampdoria,Serie A,19,2003,3.2,2,2,0,2,0,1,5,20.0,4,1,0,1,5,7,9,0,Matches
2030,Antonios Papadopoulos,GER,DF,Dortmund,Bundesliga,22,1999,0.1,0,0,0,0,0,0,0,0.0,0,0,0,0,1,1,0,0,Matches
2031,Lucas Paquetá,BRA,MF,West Ham,Premier League,24,1997,23.9,71,53,23,36,12,27,66,40.9,39,41,4,37,16,87,31,0,Matches
2032,Lucas Paquetá,BRA,MF,Lyon,Ligue 1,24,1997,1.8,5,4,0,5,0,1,3,33.3,2,2,0,2,1,6,3,0,Matches
2033,Aitor Paredes,ESP,DF,Athletic Club,La Liga,22,2000,9.5,7,6,4,2,1,6,11,54.5,5,11,7,4,14,21,26,0,Matches
2034,Kevin Paredes,USA,"FW,MF",Wolfsburg,Bundesliga,19,2003,5.9,13,9,6,3,4,9,12,75.0,3,7,0,7,6,19,8,0,Matches
2035,Leandro Paredes,ARG,MF,Juventus,Serie A,28,1994,10.9,19,13,7,11,1,10,22,45.5,12,8,0,8,17,36,22,0,Matches
2036,Leandro Paredes,ARG,MF,Paris S-G,Ligue 1,28,1994,0.6,1,1,1,0,0,1,1,100.0,0,2,1,1,1,2,0,0,Matches
2037,Daniel Parejo,ESP,MF,Villarreal,La Liga,33,1989,36.5,71,40,32,23,16,30,75,40.0,45,40,12,28,29,100,31,2,Matches
2038,Fabiano Parisi,ITA,DF,Empoli,Serie A,21,2000,31.4,65,35,37,21,7,30,72,41.7,42,51,16,35,41,106,91,0,Matches
2039,Moises Parra Gutierrez,ESP,FW,Getafe,La Liga,20,2002,0.1,1,0,0,1,0,0,0,0.0,0,0,0,0,0,1,0,0,Matches
2040,Raúl Parra,ESP,DF,Cádiz,La Liga,22,1999,3.4,4,2,4,0,0,4,9,44.4,5,5,3,2,1,5,9,0,Matches
2041,Thomas Partey,GHA,MF,Arsenal,Premier League,29,1993,27.6,70,40,20,35,15,25,52,48.1,27,26,5,21,28,98,41,1,Matches
2042,Marco Pašalić,CRO,MF,Dortmund,Bundesliga,21,2000,0.1,0,0,0,0,0,0,0,0.0,0,0,0,0,0,0,0,0,Matches
2043,Mario Pašalić,CRO,"MF,FW",Atalanta,Serie A,27,1995,19.7,22,10,6,14,2,6,23,26.1,17,22,4,18,21,43,13,0,Matches
2044,Pascu,ESP,"DF,FW",Villarreal,La Liga,19,2003,0.1,0,0,0,0,0,0,0,0.0,0,0,0,0,0,0,0,0,Matches
2045,Felix Passlack,GER,DF,Dortmund,Bundesliga,24,1998,0.7,4,3,0,4,0,1,1,100.0,0,1,1,0,0,4,1,0,Matches
2046,Javier Pastore,ARG,MF,Elche,La Liga,33,1989,0.1,0,0,0,0,0,0,0,0.0,0,0,0,0,0,0,0,0,Matches
2047,Patric,ESP,DF,Lazio,Serie A,29,1993,15.7,17,11,12,3,2,11,16,68.8,5,17,12,5,11,28,53,1,Matches
2048,Rui Patrício,POR,GK,Roma,Serie A,34,1988,35.0,1,1,1,0,0,1,1,100.0,0,0,0,0,2,3,6,3,Matches
2049,Nathan Patterson,SCO,"DF,MF",Everton,Premier League,20,2001,14.2,49,24,32,13,4,29,53,54.7,24,24,4,20,15,64,45,0,Matches
2050,Paulinho,BRA,FW,Leverkusen,Bundesliga,22,2000,0.9,0,0,0,0,0,0,0,0.0,0,1,0,1,0,0,2,0,Matches
2051,Gabriel Paulista,BRA,DF,Valencia,La Liga,31,1990,16.7,17,9,13,4,0,13,19,68.4,6,22,14,8,32,49,79,2,Matches
2052,Benjamin Pavard,FRA,DF,Bayern Munich,Bundesliga,26,1996,27.0,70,41,36,26,8,36,48,75.0,12,35,16,19,44,114,83,0,Matches
2053,Jiří Pavlenka,CZE,GK,Werder Bremen,Bundesliga,30,1992,32.3,1,0,1,0,0,1,5,20.0,4,1,0,1,3,4,21,1,Matches
2054,Dimitri Payet,FRA,"MF,FW",Marseille,Ligue 1,35,1987,9.3,6,4,2,2,2,3,10,30.0,7,4,0,4,0,6,4,0,Matches
2055,Ben Pearson,ENG,MF,Bournemouth,Premier League,27,1995,3.2,7,3,3,3,1,1,3,33.3,2,4,0,4,2,9,6,0,Matches
2056,Kristian Pedersen,DEN,DF,Köln,Bundesliga,27,1994,3.1,5,4,4,1,0,0,2,0.0,2,3,0,3,6,11,17,0,Matches
2057,Mads Pedersen,DEN,"DF,MF",Augsburg,Bundesliga,25,1996,20.4,44,23,31,11,2,22,33,66.7,11,32,9,23,20,64,41,1,Matches
2058,Alfonso Pedraza,ESP,DF,Villarreal,La Liga,26,1996,18.1,35,26,20,10,5,19,29,65.5,10,19,1,18,18,53,31,0,Matches
2059,Pedri,ESP,MF,Barcelona,La Liga,19,2002,22.0,39,22,15,17,7,13,45,28.9,32,27,0,27,13,52,8,1,Matches
2060,Pedro,ESP,FW,Lazio,Serie A,35,1987,21.1,35,24,14,10,11,11,30,36.7,19,18,2,16,6,41,4,1,Matches
2061,Adrià Pedrosa,ESP,"DF,MF",Espanyol,La Liga,24,1998,2.5,5,1,5,0,0,4,7,57.1,3,1,1,0,5,10,3,0,Matches
2062,Jordan Pefok,USA,FW,Union Berlin,Bundesliga,26,1996,15.1,15,7,3,4,8,2,17,11.8,15,17,5,12,4,19,15,0,Matches
2063,Gianluca Pegolo,ITA,GK,Sassuolo,Serie A,41,1981,2.0,0,0,0,0,0,0,1,0.0,1,0,0,0,0,0,1,0,Matches
2064,Dženan Pejčinović,GER,FW,Wolfsburg,Bundesliga,17,2005,0.1,0,0,0,0,0,0,0,0.0,0,0,0,0,0,0,0,0,Matches
2065,Peter Pekarík,SVK,DF,Hertha BSC,Bundesliga,35,1986,2.3,4,3,4,0,0,4,6,66.7,2,6,2,4,4,8,7,0,Matches
2066,Pietro Pellegri,ITA,FW,Torino,Serie A,21,2001,5.2,6,2,1,3,2,2,3,66.7,1,5,1,4,0,6,4,0,Matches
2067,Lorenzo Pellegrini,ITA,MF,Roma,Serie A,26,1996,28.3,52,29,24,24,4,22,48,45.8,26,27,4,23,26,78,22,0,Matches
2068,Luca Pellegrini,ITA,DF,Lazio,Serie A,23,1999,2.0,1,0,0,1,0,1,4,25.0,3,3,0,3,7,8,4,0,Matches
2069,Luca Pellegrini,ITA,DF,Eint Frankfurt,Bundesliga,23,1999,6.2,13,8,10,3,0,8,8,100.0,0,8,2,6,7,20,11,1,Matches
2070,Théo Pellenard,FRA,DF,Auxerre,Ligue 1,28,1994,1.1,1,0,1,0,0,1,1,100.0,0,3,1,2,2,3,2,0,Matches
2071,Facundo Pellistri,URU,"FW,MF",Manchester Utd,Premier League,20,2001,0.7,1,1,0,1,0,0,0,0.0,0,0,0,0,0,1,3,0,Matches
2072,Timothee Pembele,FRA,DF,Paris S-G,Ligue 1,19,2002,2.9,5,5,3,1,1,2,4,50.0,2,2,0,2,4,9,2,0,Matches
2073,Iñaki Peña,ESP,GK,Barcelona,La Liga,23,1999,0.8,0,0,0,0,0,0,0,0.0,0,0,0,0,0,0,0,1,Matches
2074,Rubén Peña,ESP,"DF,MF",Osasuna,La Liga,31,1991,14.2,32,18,10,18,4,20,41,48.8,21,23,8,15,17,49,31,0,Matches
2075,Patrick Pentz,AUT,GK,Reims,Ligue 1,25,1997,7.0,0,0,0,0,0,0,0,0.0,0,0,0,0,0,0,1,0,Matches
2076,Nicolas Pépé,CIV,"FW,MF",Nice,Ligue 1,27,1995,16.6,25,13,14,5,6,11,25,44.0,14,17,0,17,3,28,1,0,Matches
2077,Ricardo Pepi,USA,FW,Augsburg,Bundesliga,19,2003,1.1,1,1,1,0,0,1,1,100.0,0,1,0,1,0,1,1,0,Matches
2078,Pepín,EQG,MF,Monza,Serie A,25,1996,12.5,28,19,10,11,7,9,27,33.3,18,14,3,11,13,41,17,0,Matches
2079,Alberto Perea,ESP,MF,Cádiz,La Liga,31,1990,0.5,2,0,2,0,0,0,0,0.0,0,2,0,2,0,2,0,0,Matches
2080,Juan Perea,COL,FW,Stuttgart,Bundesliga,22,2000,4.6,5,4,0,2,3,2,4,50.0,2,2,1,1,1,6,3,0,Matches
2081,Andreas Pereira,BRA,MF,Fulham,Premier League,26,1996,29.9,18,9,3,6,9,8,33,24.2,25,21,3,18,6,24,8,0,Matches
2082,Brayann Pereira,FRA,DF,Auxerre,Ligue 1,19,2003,2.0,6,5,5,1,0,1,5,20.0,4,2,2,0,2,8,8,1,Matches
2083,Danilo Pereira,POR,"DF,MF",Paris S-G,Ligue 1,30,1991,26.8,32,17,15,14,3,19,26,73.1,7,26,19,7,36,68,59,1,Matches
2084,Mathias Pereira Lage,POR,"MF,FW",Brest,Ligue 1,25,1996,14.0,20,7,5,14,1,11,29,37.9,18,10,1,9,14,34,12,0,Matches
2085,Ricardo Pereira,POR,"DF,MF",Leicester City,Premier League,28,1993,5.0,11,7,8,3,0,7,17,41.2,10,8,2,6,4,15,20,0,Matches
2086,Roberto Pereyra,ARG,"DF,MF",Udinese,Serie A,31,1991,31.3,36,20,21,12,3,16,44,36.4,28,20,5,15,16,52,28,0,Matches
2087,Ayoze Pérez,ESP,"MF,FW",Leicester City,Premier League,29,1993,4.2,11,8,5,4,2,8,19,42.1,11,6,0,6,2,13,3,0,Matches
2088,Ayoze Pérez,ESP,"FW,MF",Betis,La Liga,29,1993,15.4,31,15,9,16,6,10,40,25.0,30,22,0,22,13,44,5,0,Matches
2089,Carles Pérez,ESP,"MF,FW",Celta Vigo,La Liga,24,1998,23.8,39,23,12,17,10,22,66,33.3,44,29,3,26,6,45,9,0,Matches
2090,Francisco Perez,ESP,"FW,MF",Valencia,La Liga,19,2002,1.6,1,1,1,0,0,0,3,0.0,3,0,0,0,0,1,1,0,Matches
2091,Kike Pérez,ESP,MF,Valladolid,La Liga,25,1997,25.6,67,33,30,32,5,25,68,36.8,43,26,7,19,20,87,28,0,Matches
2092,Lucas Pérez,ESP,FW,Cádiz,La Liga,33,1988,7.0,3,2,2,1,0,1,3,33.3,2,2,0,2,1,4,3,0,Matches
2093,Luis Pérez,ESP,DF,Valladolid,La Liga,27,1995,13.5,44,24,26,12,6,27,38,71.1,11,13,4,9,16,60,29,0,Matches
2094,Nehuén Pérez,ARG,DF,Udinese,Serie A,22,2000,31.3,77,40,54,20,3,39,55,70.9,16,53,23,30,35,112,106,1,Matches
2095,Simone Perilli,ITA,GK,Hellas Verona,Serie A,27,1995,1.0,0,0,0,0,0,0,0,0.0,0,0,0,0,0,0,0,0,Matches
2096,Mattia Perin,ITA,GK,Juventus,Serie A,29,1992,10.5,0,0,0,0,0,0,0,0.0,0,0,0,0,0,0,0,0,Matches
2097,Samuele Perisan,ITA,GK,Empoli,Serie A,24,1997,7.0,0,0,0,0,0,0,0,0.0,0,0,0,0,0,0,2,0,Matches
2098,Ivan Perišić,CRO,"DF,MF",Tottenham,Premier League,33,1989,23.4,42,24,25,10,7,27,47,57.4,20,29,7,22,22,64,49,1,Matches
2099,Romain Perraud,FRA,DF,Southampton,Premier League,24,1997,20.4,54,33,23,23,8,28,52,53.8,24,24,6,18,20,74,42,0,Matches
2100,Gaëtan Perrin,FRA,"MF,FW",Auxerre,Ligue 1,26,1996,15.5,17,8,5,6,6,8,30,26.7,22,15,0,15,10,27,9,0,Matches
2101,Lucas Perrin,FRA,DF,Strasbourg,Ligue 1,23,1998,19.6,44,27,28,14,2,25,49,51.0,24,13,5,8,36,80,53,0,Matches
2102,Máximo Perrone,ARG,MF,Manchester City,Premier League,19,2003,0.2,0,0,0,0,0,0,0,0.0,0,1,0,1,0,0,0,0,Matches
2103,Matteo Pessina,ITA,MF,Monza,Serie A,25,1997,32.6,57,36,28,21,8,26,62,41.9,36,50,15,35,37,94,33,1,Matches
2104,Andrea Petagna,ITA,FW,Monza,Serie A,27,1995,18.5,7,5,2,3,2,3,6,50.0,3,16,4,12,3,10,18,0,Matches
2105,Nils Petersen,GER,FW,Freiburg,Bundesliga,33,1988,3.1,6,4,0,3,3,2,5,40.0,3,11,2,9,1,7,6,0,Matches
2106,Lukas Petkov,BUL,"MF,FW",Augsburg,Bundesliga,21,2000,1.6,5,1,4,1,0,2,3,66.7,1,4,1,3,1,6,0,0,Matches
2107,Cameron Peupion,AUS,MF,Brighton,Premier League,19,2002,0.1,0,0,0,0,0,0,0,0.0,0,0,0,0,0,0,0,0,Matches
2108,Germán Pezzella,ARG,DF,Betis,La Liga,31,1991,27.9,41,28,32,9,0,26,38,68.4,12,32,15,17,50,91,129,1,Matches
2109,Giuseppe Pezzella,ITA,DF,Lecce,Serie A,24,1997,10.2,21,9,16,2,3,9,16,56.3,7,11,3,8,8,29,31,1,Matches
2110,Luca Pfeiffer,GER,FW,Stuttgart,Bundesliga,25,1996,7.8,1,1,1,0,0,0,1,0.0,1,4,0,4,1,2,5,0,Matches
2111,Maximilian Philipp,GER,FW,Wolfsburg,Bundesliga,28,1994,1.3,2,1,1,1,0,1,1,100.0,0,1,0,1,0,2,0,0,Matches
2112,Maximilian Philipp,GER,"FW,MF",Werder Bremen,Bundesliga,28,1994,4.9,6,5,3,2,1,1,9,11.1,8,7,1,6,3,9,4,0,Matches
2113,Kalvin Phillips,ENG,MF,Manchester City,Premier League,26,1995,3.3,6,4,3,3,0,2,9,22.2,7,7,3,4,5,11,10,0,Matches
2114,Nathaniel Phillips,ENG,DF,Liverpool,Premier League,25,1997,0.7,2,1,0,2,0,2,2,100.0,0,0,0,0,2,4,1,0,Matches
2115,Krzysztof Piątek,POL,FW,Salernitana,Serie A,27,1995,23.8,18,11,3,9,6,5,21,23.8,16,17,4,13,2,20,39,0,Matches
2116,Roberto Piccoli,ITA,FW,Hellas Verona,Serie A,21,2001,2.1,1,0,1,0,0,0,2,0.0,2,2,0,2,0,1,2,0,Matches
2117,Roberto Piccoli,ITA,FW,Empoli,Serie A,21,2001,5.7,1,1,1,0,0,0,3,0.0,3,4,1,3,1,2,9,0,Matches
2118,Charles Pickel,COD,MF,Cremonese,Serie A,25,1997,27.6,55,23,25,26,4,32,57,56.1,25,37,5,32,24,79,36,1,Matches
2119,Jordan Pickford,ENG,GK,Everton,Premier League,28,1994,37.0,0,0,0,0,0,0,1,0.0,1,0,0,0,4,4,15,3,Matches
2120,Amos Pieper,GER,DF,Werder Bremen,Bundesliga,24,1998,21.7,46,28,25,19,2,24,40,60.0,16,23,11,12,30,76,94,1,Matches
2121,Ronaël Pierre-Gabriel,FRA,DF,Espanyol,La Liga,24,1998,2.6,17,9,12,4,1,5,11,45.5,6,5,2,3,9,26,11,0,Matches
2122,Ronaël Pierre-Gabriel,FRA,DF,Strasbourg,Ligue 1,24,1998,7.3,25,18,11,12,2,15,17,88.2,2,16,3,13,9,34,22,0,Matches
2123,Andrea Pinamonti,ITA,FW,Sassuolo,Serie A,23,1999,24.0,10,7,0,5,5,3,7,42.9,4,19,2,17,2,12,11,0,Matches
2124,Ethan Pinnock,JAM,DF,Brentford,Premier League,29,1993,30.0,52,28,33,12,7,18,24,75.0,6,41,31,10,35,87,215,2,Matches
2125,Yeremi Pino,ESP,"FW,MF",Villarreal,La Liga,19,2002,27.2,62,38,25,20,17,21,56,37.5,35,41,4,37,15,77,36,0,Matches
2126,Gerard Piqué,ESP,DF,Barcelona,La Liga,35,1987,4.3,5,4,1,4,0,4,4,100.0,0,2,1,1,2,7,19,0,Matches
2127,Lorenzo Pirola,ITA,DF,Salernitana,Serie A,20,2002,21.6,33,29,18,14,1,19,27,70.4,8,50,35,15,30,63,85,1,Matches
2128,Niccolò Pisilli,ITA,MF,Roma,Serie A,17,2004,0.0,0,0,0,0,0,0,0,0.0,0,0,0,0,0,0,0,0,Matches
2129,Marko Pjaca,CRO,"MF,FW",Empoli,Serie A,27,1995,5.8,4,3,3,1,0,3,5,60.0,2,3,0,3,3,7,3,0,Matches
2130,Óscar Plano,ESP,"FW,MF",Valladolid,La Liga,31,1991,22.6,40,25,9,17,14,12,37,32.4,25,26,2,24,29,69,23,0,Matches
2131,Gonzalo Plata,ECU,FW,Valladolid,La Liga,21,2000,25.6,66,35,31,24,11,23,70,32.9,47,40,0,40,12,78,10,1,Matches
2132,Marvin Plattenhardt,GER,DF,Hertha BSC,Bundesliga,30,1992,26.7,43,33,24,15,4,29,47,61.7,18,25,11,14,15,58,82,0,Matches
2133,Alassane Pléa,FRA,FW,M'Gladbach,Bundesliga,29,1993,19.7,16,8,5,7,4,8,26,30.8,18,23,3,20,12,28,14,0,Matches
2134,Tommaso Pobega,ITA,MF,Milan,Serie A,23,1999,9.8,27,16,8,15,4,13,20,65.0,7,12,4,8,9,36,11,0,Matches
2135,Daniel Podence,POR,"FW,MF",Wolves,Premier League,26,1995,19.7,27,17,13,9,5,6,31,19.4,25,19,0,19,7,34,6,0,Matches
2136,Paul Pogba,FRA,"MF,FW",Juventus,Serie A,29,1993,1.2,0,0,0,0,0,0,1,0.0,1,0,0,0,0,0,2,0,Matches
2137,Joel Pohjanpalo,FIN,"FW,MF",Leverkusen,Bundesliga,27,1994,0.0,0,0,0,0,0,0,0,0.0,0,0,0,0,0,0,0,0,Matches
2138,Matteo Politano,ITA,FW,Napoli,Serie A,28,1993,13.0,18,9,9,5,4,11,25,44.0,14,6,0,6,7,25,7,0,Matches
2139,Sebastian Polter,GER,FW,Schalke 04,Bundesliga,31,1991,7.0,4,3,0,4,0,1,4,25.0,3,4,0,4,1,5,6,0,Matches
2140,Ezequiel Ponce,ARG,"FW,MF",Elche,La Liga,25,1997,12.5,9,7,0,6,3,0,7,0.0,7,6,1,5,1,10,13,0,Matches
2141,Julien Ponceau,FRA,MF,Lorient,Ligue 1,21,2000,18.4,28,19,10,14,4,10,32,31.3,22,27,3,24,14,42,12,0,Matches
2142,Marin Pongračić,CRO,DF,Lecce,Serie A,24,1997,8.8,16,14,8,7,1,5,7,71.4,2,4,3,1,16,32,31,0,Matches
2143,Nick Pope,ENG,GK,Newcastle Utd,Premier League,30,1992,36.2,1,0,1,0,0,1,3,33.3,2,0,0,0,0,1,27,2,Matches
2144,Łukasz Poręba,POL,MF,Lens,Ligue 1,22,2000,2.9,5,4,2,1,2,2,3,66.7,1,3,0,3,4,9,2,0,Matches
2145,Jackson Porozo,ECU,DF,Troyes,Ligue 1,21,2000,18.0,32,20,24,7,1,13,31,41.9,18,24,17,7,33,65,75,0,Matches
2146,Pedro Porro,ESP,"DF,MF",Tottenham,Premier League,22,1999,12.6,25,16,8,15,2,14,39,35.9,25,25,2,23,15,40,24,1,Matches
2147,Francisco Portillo,ESP,"MF,FW",Almería,La Liga,32,1990,8.0,13,6,4,5,4,3,16,18.8,13,7,1,6,7,20,8,0,Matches
2148,Portu,ESP,"MF,DF",Getafe,La Liga,30,1992,19.7,28,21,14,10,4,18,42,42.9,24,23,3,20,17,45,20,1,Matches
2149,Stefan Posch,AUT,DF,Bologna,Serie A,25,1997,28.1,81,43,41,29,11,44,75,58.7,31,44,15,29,35,116,69,0,Matches
2150,Stefan Posch,AUT,DF,Hoffenheim,Bundesliga,25,1997,0.2,0,0,0,0,0,0,0,0.0,0,0,0,0,0,0,0,0,Matches
2151,Yussuf Poulsen,DEN,FW,RB Leipzig,Bundesliga,28,1994,4.6,6,4,1,4,1,2,5,40.0,3,3,1,2,0,6,5,0,Matches
2152,José Pozo,ESP,"MF,FW",Rayo Vallecano,La Liga,26,1996,1.0,2,2,0,2,0,0,0,0.0,0,0,0,0,1,3,1,0,Matches
2153,Manuel Pozo,ESP,FW,Valladolid,La Liga,20,2001,0.2,0,0,0,0,0,0,0,0.0,0,2,0,2,2,2,0,0,Matches
2154,Alejandro Pozo Pozo,ESP,DF,Almería,La Liga,23,1999,20.9,37,19,17,17,3,27,53,50.9,26,30,5,25,26,63,45,1,Matches
2155,Dennis Praet,BEL,"MF,FW",Leicester City,Premier League,28,1994,7.2,12,9,5,6,1,6,11,54.5,5,12,2,10,5,17,6,0,Matches
2156,Abdón Prats,ESP,"FW,MF",Mallorca,La Liga,29,1992,4.6,1,0,1,0,0,0,0,0.0,0,5,0,5,0,1,2,0,Matches
2157,Sanjin Prcić,BIH,MF,Strasbourg,Ligue 1,28,1993,18.1,27,12,6,16,5,19,31,61.3,12,22,7,15,25,52,22,0,Matches
2158,Isaac Price,NIR,MF,Everton,Premier League,18,2003,0.4,0,0,0,0,0,0,1,0.0,1,1,1,0,0,0,0,0,Matches
2159,Grischa Prömel,GER,MF,Hoffenheim,Bundesliga,27,1995,16.2,27,19,14,11,2,9,25,36.0,16,22,4,18,8,35,23,0,Matches
2160,Ivan Provedel,ITA,GK,Lazio,Serie A,28,1994,37.9,1,0,1,0,0,0,0,0.0,0,0,0,0,0,1,15,1,Matches
2161,Javi Puado,ESP,"FW,MF",Espanyol,La Liga,24,1998,26.0,20,11,12,5,3,12,28,42.9,16,12,2,10,10,30,14,0,Matches
2162,Mehdi Puch Herrantz,FRA,MF,Ajaccio,Ligue 1,18,2004,0.5,2,2,0,1,1,1,2,50.0,1,1,0,1,3,5,0,0,Matches
2163,Tymoteusz Puchacz,POL,DF,Union Berlin,Bundesliga,23,1999,0.6,1,0,1,0,0,0,0,0.0,0,0,0,0,0,1,1,0,Matches
2164,Arnau Puigmal,ESP,"MF,FW",Almería,La Liga,21,2001,8.5,22,14,10,7,5,12,17,70.6,5,7,0,7,11,33,6,0,Matches
2165,Christian Pulisic,USA,"FW,DF",Chelsea,Premier League,23,1998,9.1,11,6,3,6,2,3,5,60.0,2,8,1,7,4,15,4,0,Matches
2166,Ignacio Pussetto,ARG,"MF,DF",Sampdoria,Serie A,26,1995,1.7,6,3,2,3,1,3,4,75.0,1,4,0,4,0,6,3,0,Matches
2167,Niklas Pyyhtiä,FIN,MF,Bologna,Serie A,18,2003,1.2,1,0,0,1,0,0,1,0.0,1,1,1,0,1,2,4,0,Matches
2168,Fabio Quagliarella,ITA,FW,Sampdoria,Serie A,39,1983,8.9,2,1,1,1,0,1,7,14.3,6,5,1,4,0,2,9,0,Matches
2169,Giacomo Quagliata,ITA,DF,Cremonese,Serie A,22,2000,7.8,10,8,7,1,2,5,11,45.5,6,7,2,5,11,21,8,0,Matches
2170,Eduardo Quaresma,POR,DF,Hoffenheim,Bundesliga,20,2002,1.0,5,3,3,2,0,1,3,33.3,2,3,2,1,0,5,3,0,Matches
2171,Joshua Quarshie,GER,MF,Hoffenheim,Bundesliga,18,2004,0.0,0,0,0,0,0,0,0,0.0,0,0,0,0,0,0,0,0,Matches
2172,Ghjuvanni Quilichini,FRA,GK,Ajaccio,Ligue 1,19,2002,0.9,0,0,0,0,0,0,0,0.0,0,0,0,0,0,0,1,0,Matches
2173,Domingos Quina,POR,MF,Elche,La Liga,22,1999,3.1,3,2,2,1,0,1,3,33.3,2,5,0,5,3,6,1,0,Matches
2174,Rubén Quintanilla,ESP,DF,Mallorca,La Liga,20,2002,0.0,0,0,0,0,0,0,0,0.0,0,1,0,1,0,0,0,0,Matches
2175,Adrien Rabiot,FRA,MF,Juventus,Serie A,27,1995,30.5,65,35,31,23,11,30,57,52.6,27,37,7,30,26,91,44,1,Matches
2176,Nemanja Radonjić,SRB,"MF,FW",Torino,Serie A,26,1996,16.2,2,1,2,0,0,0,4,0.0,4,3,0,3,2,4,4,0,Matches
2177,Ivan Radovanović,SRB,"MF,DF",Salernitana,Serie A,33,1988,7.5,12,4,8,4,0,4,10,40.0,6,9,3,6,7,19,9,1,Matches
2178,Ionuț Radu,ROU,GK,Cremonese,Serie A,25,1997,9.0,0,0,0,0,0,0,0,0.0,0,0,0,0,0,0,1,3,Matches
2179,Ionuț Radu,ROU,GK,Auxerre,Ligue 1,25,1997,17.0,0,0,0,0,0,0,0,0.0,0,0,0,0,0,0,3,2,Matches
2180,Ștefan Radu,ROU,FW,Lazio,Serie A,35,1986,0.0,0,0,0,0,0,0,0,0.0,0,0,0,0,0,0,0,0,Matches
2181,Antonio Raillo,ESP,DF,Mallorca,La Liga,30,1991,30.7,34,21,23,11,0,10,15,66.7,5,38,29,9,31,65,158,1,Matches
2182,Antonio Raimondo,ITA,FW,Bologna,Serie A,18,2004,0.2,0,0,0,0,0,0,0,0.0,0,0,0,0,0,0,1,0,Matches
2183,Predrag Rajković,SRB,GK,Mallorca,La Liga,26,1995,36.0,0,0,0,0,0,0,2,0.0,2,0,0,0,0,0,16,1,Matches
2184,Ivan Rakitić,CRO,MF,Sevilla,La Liga,34,1988,19.9,37,26,10,18,9,19,40,47.5,21,21,1,20,27,64,20,0,Matches
2185,Diant Ramaj,GER,GK,Eint Frankfurt,Bundesliga,20,2001,1.0,0,0,0,0,0,0,0,0.0,0,0,0,0,0,0,1,0,Matches
2186,Largie Ramazani,BEL,"FW,MF",Almería,La Liga,21,2001,15.6,15,9,6,3,6,8,27,29.6,19,11,0,11,15,30,10,0,Matches
2187,Simon Ramet,FRA,DF,Lille,Ligue 1,19,2003,0.0,0,0,0,0,0,0,0,0.0,0,0,0,0,0,0,0,0,Matches
2188,Adil Rami,FRA,DF,Troyes,Ligue 1,36,1985,17.7,19,14,13,5,1,17,32,53.1,15,23,16,7,25,44,75,3,Matches
2189,Chris Ramos,ESP,FW,Cádiz,La Liga,25,1997,7.9,12,9,2,7,3,4,11,36.4,7,8,3,5,1,13,19,0,Matches
2190,Sergio Ramos,ESP,DF,Paris S-G,Ligue 1,36,1986,30.0,34,26,14,18,2,23,44,52.3,21,29,13,16,34,68,93,3,Matches
2191,Aaron Ramsdale,ENG,GK,Arsenal,Premier League,24,1998,38.0,1,1,1,0,0,1,1,100.0,0,0,0,0,0,1,20,6,Matches
2192,Aaron Ramsey,WAL,MF,Nice,Ligue 1,31,1990,17.6,47,25,18,19,10,16,39,41.0,23,25,4,21,17,64,18,1,Matches
2193,Jacob Ramsey,ENG,"MF,FW",Aston Villa,Premier League,21,2001,29.3,69,39,23,35,11,32,69,46.4,37,48,8,40,23,92,34,0,Matches
2194,Luca Ranieri,ITA,DF,Fiorentina,Serie A,23,1999,5.6,9,4,6,3,0,6,9,66.7,3,5,3,2,11,20,15,1,Matches
2195,Andrea Ranocchia,ITA,DF,Monza,Serie A,34,1988,0.5,3,1,1,2,0,3,4,75.0,1,5,5,0,0,3,7,0,Matches
2196,Filippo Ranocchia,ITA,MF,Monza,Serie A,21,2001,5.9,11,6,5,4,2,4,12,33.3,8,5,1,4,4,15,7,0,Matches
2197,Lilian Raolisoa,FRA,"DF,MF",Angers,Ligue 1,22,2000,1.9,11,9,6,3,2,7,10,70.0,3,3,1,2,3,14,5,0,Matches
2198,Raphinha,BRA,FW,Barcelona,La Liga,25,1996,23.0,29,19,10,7,12,11,31,35.5,20,33,1,32,14,43,11,1,Matches
2199,Nicolai Rapp,GER,"MF,DF",Werder Bremen,Bundesliga,25,1996,0.8,3,1,3,0,0,0,3,0.0,3,0,0,0,0,3,1,0,Matches
2200,Elba Rashani,KVX,"MF,FW",Clermont Foot,Ligue 1,29,1993,24.0,39,26,13,19,7,13,39,33.3,26,27,2,25,21,60,19,0,Matches
2201,Marcus Rashford,ENG,FW,Manchester Utd,Premier League,24,1997,32.0,20,10,7,8,5,9,24,37.5,15,31,4,27,7,27,14,0,Matches
2202,Giacomo Raspadori,ITA,"FW,MF",Napoli,Serie A,22,2000,10.1,10,8,0,6,4,4,10,40.0,6,9,0,9,4,14,4,0,Matches
2203,Giacomo Raspadori,ITA,FW,Sassuolo,Serie A,22,2000,0.5,0,0,0,0,0,0,0,0.0,0,0,0,0,0,0,0,0,Matches
2204,Rafael Ratão,BRA,"FW,MF",Toulouse,Ligue 1,26,1995,20.6,52,36,29,16,7,27,73,37.0,46,34,0,34,21,73,7,0,Matches
2205,David Raum,GER,"DF,MF",RB Leipzig,Bundesliga,24,1998,18.7,39,25,23,12,4,17,29,58.6,12,24,6,18,16,55,26,1,Matches
2206,Nicola Ravaglia,ITA,GK,Sampdoria,Serie A,33,1988,9.0,0,0,0,0,0,0,1,0.0,1,0,0,0,0,0,7,0,Matches
2207,Rayan Raveloson,MAD,"DF,MF",Auxerre,Ligue 1,25,1997,27.0,38,23,21,16,1,23,33,69.7,10,43,12,31,39,77,70,0,Matches
2208,David Raya,ESP,GK,Brentford,Premier League,26,1995,38.0,0,0,0,0,0,0,2,0.0,2,1,0,1,1,1,10,2,Matches
2209,Tim Ream,USA,DF,Fulham,Premier League,34,1987,32.2,30,16,15,12,3,13,26,50.0,13,45,24,21,41,71,116,2,Matches
2210,Ante Rebić,CRO,"FW,MF",Milan,Serie A,28,1993,10.9,10,8,1,3,6,3,11,27.3,8,6,1,5,1,11,5,0,Matches
2211,Arkadiusz Reca,POL,DF,Spezia,Serie A,27,1995,24.1,44,28,22,12,10,19,32,59.4,13,21,5,16,24,68,54,0,Matches
2212,Nathan Redmond,ENG,DF,Southampton,Premier League,28,1994,0.0,0,0,0,0,0,0,0,0.0,0,0,0,0,0,0,0,0,Matches
2213,Harrison Reed,ENG,MF,Fulham,Premier League,27,1995,31.8,44,27,17,21,6,16,50,32.0,34,54,12,42,19,63,36,0,Matches
2214,Sergio Reguilón,ESP,DF,Atlético Madrid,La Liga,25,1996,3.4,7,5,5,2,0,5,7,71.4,2,3,0,3,2,9,4,0,Matches
2215,Bobby Reid,JAM,"FW,DF",Fulham,Premier League,29,1993,27.5,42,24,14,14,14,16,34,47.1,18,25,3,22,20,62,28,1,Matches
2216,Pepe Reina,ESP,GK,Villarreal,La Liga,39,1982,22.0,0,0,0,0,0,0,1,0.0,1,0,0,0,1,1,4,4,Matches
2217,Jeff Reine-Adélaïde,FRA,MF,Troyes,Ligue 1,24,1998,2.6,3,2,2,1,0,1,2,50.0,1,2,0,2,2,5,1,0,Matches
2218,Jeff Reine-Adélaïde,FRA,MF,Lyon,Ligue 1,24,1998,3.7,8,5,1,5,2,5,9,55.6,4,4,0,4,6,14,0,0,Matches
2219,Reinier,BRA,"MF,FW",Girona,La Liga,20,2002,7.2,12,10,7,3,2,2,8,25.0,6,6,0,6,5,17,4,0,Matches
2220,Rocco Reitz,GER,MF,M'Gladbach,Bundesliga,20,2002,0.0,0,0,0,0,0,0,0,0.0,0,0,0,0,0,0,0,0,Matches
2221,Karim Rekik,NED,DF,Sevilla,La Liga,27,1994,13.1,11,5,8,3,0,4,5,80.0,1,12,5,7,10,21,24,0,Matches
2222,Álex Remiro,ESP,GK,Real Sociedad,La Liga,27,1995,38.0,1,1,1,0,0,1,3,33.3,2,0,0,0,0,1,17,3,Matches
2223,Panagiotis Retsos,GRE,DF,Hellas Verona,Serie A,23,1998,1.4,5,4,2,2,1,3,3,100.0,0,4,1,3,2,7,3,0,Matches
2224,Marco Reus,GER,"MF,FW",Dortmund,Bundesliga,33,1989,15.0,30,17,12,14,4,7,24,29.2,17,12,4,8,8,38,8,0,Matches
2225,Alejandro Revuelta Montero,ESP,DF,Getafe,La Liga,22,2000,0.0,0,0,0,0,0,0,0,0.0,0,0,0,0,0,0,1,0,Matches
2226,Elvis Rexhbeçaj,GER,MF,Augsburg,Bundesliga,24,1997,28.0,51,30,18,24,9,29,59,49.2,30,40,13,27,17,68,40,0,Matches
2227,Gio Reyna,USA,"FW,MF",Dortmund,Bundesliga,19,2002,6.9,14,7,2,5,7,5,10,50.0,5,8,2,6,3,17,5,0,Matches
2228,Chadi Riad,MAR,MF,Barcelona,La Liga,19,2003,0.0,0,0,0,0,0,0,0,0.0,0,0,0,0,0,0,0,0,Matches
2229,Nico Ribaudo,ESP,"MF,FW",Espanyol,La Liga,21,2001,13.9,18,13,5,9,4,11,30,36.7,19,19,1,18,5,23,1,0,Matches
2230,Alexsandro Ribeiro,BRA,DF,Lille,Ligue 1,22,1999,17.9,32,18,24,7,1,19,28,67.9,9,11,2,9,25,57,59,1,Matches
2231,Franck Ribéry,FRA,MF,Salernitana,Serie A,39,1983,0.4,0,0,0,0,0,0,0,0.0,0,1,0,1,0,0,0,0,Matches
2232,Samuele Ricci,ITA,MF,Torino,Serie A,20,2001,23.0,32,21,17,10,5,18,23,78.3,5,20,5,15,17,49,29,1,Matches
2233,Declan Rice,ENG,MF,West Ham,Premier League,23,1999,36.4,79,38,44,31,4,31,50,62.0,19,45,15,30,63,142,58,0,Matches
2234,Chris Richards,USA,DF,Crystal Palace,Premier League,22,2000,5.0,9,6,8,1,0,5,7,71.4,2,10,1,9,8,17,31,0,Matches
2235,Richarlison,BRA,"MF,FW",Tottenham,Premier League,25,1997,11.2,21,16,13,5,3,12,27,44.4,15,14,1,13,5,26,10,0,Matches
2236,Marco Richter,GER,"MF,FW",Hertha BSC,Bundesliga,24,1997,20.4,43,23,18,17,8,19,48,39.6,29,29,2,27,24,67,25,0,Matches
2237,Diego Rico,ESP,DF,Real Sociedad,La Liga,29,1993,18.3,35,21,17,11,7,12,27,44.4,15,18,5,13,20,55,51,1,Matches
2238,Jaïro Riedewald,NED,"DF,MF",Crystal Palace,Premier League,25,1996,0.7,2,1,2,0,0,0,1,0.0,1,2,0,2,0,2,4,0,Matches
2239,Manuel Riemann,GER,GK,Bochum,Bundesliga,33,1988,34.0,3,2,3,0,0,3,5,60.0,2,1,0,1,5,8,23,7,Matches
2240,Tomás Rincón,VEN,MF,Sampdoria,Serie A,34,1988,28.4,56,27,22,26,8,29,61,47.5,32,37,7,30,30,86,18,0,Matches
2241,Rémy Riou,FRA,GK,Lyon,Ligue 1,34,1987,6.7,1,0,1,0,0,1,1,100.0,0,0,0,0,0,1,3,0,Matches
2242,Renaud Ripart,FRA,"FW,MF",Troyes,Ligue 1,29,1993,14.7,40,23,14,20,6,19,52,36.5,33,29,2,27,7,47,5,0,Matches
2243,Rodrigo Riquelme,ESP,"MF,FW",Girona,La Liga,22,2000,24.2,20,8,8,8,4,9,35,25.7,26,16,0,16,11,31,5,0,Matches
2244,Matt Ritchie,SCO,"FW,MF",Newcastle Utd,Premier League,32,1989,0.4,1,1,0,1,0,1,3,33.3,2,0,0,0,1,2,0,0,Matches
2245,Sergi Roberto,ESP,"DF,MF",Barcelona,La Liga,30,1992,14.5,22,15,12,6,4,7,18,38.9,11,15,7,8,11,33,16,0,Matches
2246,Lucas Robertone,ARG,MF,Almería,La Liga,25,1997,31.6,50,28,20,21,9,28,64,43.8,36,45,7,38,46,96,46,1,Matches
2247,Andrew Robertson,SCO,DF,Liverpool,Premier League,28,1994,28.7,38,21,12,16,10,21,41,51.2,20,32,5,27,18,56,50,3,Matches
2248,Antonee Robinson,USA,DF,Fulham,Premier League,24,1997,34.3,62,38,43,15,4,44,65,67.7,21,49,13,36,53,115,83,3,Matches
2249,Joel Robles,ESP,GK,Leeds United,Premier League,32,1990,4.0,0,0,0,0,0,0,1,0.0,1,0,0,0,0,0,2,1,Matches
2250,Joel Roca,ESP,"MF,FW",Girona,La Liga,17,2005,0.9,2,2,2,0,0,2,5,40.0,3,1,1,0,0,2,1,0,Matches
2251,Marc Roca,ESP,MF,Leeds United,Premier League,25,1996,25.7,66,40,27,34,5,20,65,30.8,45,34,10,24,23,89,24,2,Matches
2252,Enzo Roco,CHI,DF,Elche,La Liga,29,1992,18.4,33,13,23,10,0,15,24,62.5,9,22,15,7,17,50,63,1,Matches
2253,Marek Rodák,SVK,GK,Fulham,Premier League,25,1996,2.0,0,0,0,0,0,0,0,0.0,0,0,0,0,0,0,1,1,Matches
2254,Sebastian Rode,GER,MF,Eint Frankfurt,Bundesliga,31,1990,15.7,38,24,7,28,3,14,45,31.1,31,18,2,16,16,54,12,0,Matches
2255,Joe Rodon,WAL,DF,Rennes,Ligue 1,24,1997,15.7,11,7,9,2,0,4,10,40.0,6,16,12,4,9,20,54,1,Matches
2256,Rodri,ESP,MF,Manchester City,Premier League,26,1996,32.3,67,41,28,28,11,26,52,50.0,26,40,14,26,33,100,43,1,Matches
2257,Rodri,ESP,"FW,MF",Betis,La Liga,22,2000,17.8,16,11,5,9,2,8,17,47.1,9,10,0,10,13,29,2,0,Matches
2258,Rodrigo,ESP,"FW,MF",Leeds United,Premier League,31,1991,21.5,24,10,2,15,7,8,19,42.1,11,16,4,12,6,30,21,1,Matches
2259,Ángel Rodríguez,ESP,"FW,MF",Mallorca,La Liga,35,1987,4.4,1,1,0,1,0,0,2,0.0,2,3,0,3,1,2,1,0,Matches
2260,Óscar Rodríguez Arnaiz,ESP,MF,Celta Vigo,La Liga,24,1998,19.7,32,25,12,15,5,13,28,46.4,15,16,2,14,24,56,15,0,Matches
2261,Dani Rodríguez,ESP,MF,Mallorca,La Liga,34,1988,23.3,42,23,18,22,2,21,46,45.7,25,31,8,23,21,63,14,0,Matches
2262,Guido Rodríguez,ARG,MF,Betis,La Liga,28,1994,31.9,115,75,59,50,6,54,101,53.5,47,58,14,44,42,157,76,1,Matches
2263,Miguel Rodríguez,ESP,"MF,FW",Celta Vigo,La Liga,19,2003,2.8,7,5,4,3,0,4,11,36.4,7,6,0,6,1,8,3,0,Matches
2264,Pablo Rodríguez,ESP,"FW,MF",Lecce,Serie A,20,2001,0.6,2,1,2,0,0,0,2,0.0,2,3,0,3,0,2,0,0,Matches
2265,Ricardo Rodríguez,SUI,DF,Torino,Serie A,29,1992,29.7,54,33,30,17,7,28,42,66.7,14,30,15,15,38,92,61,0,Matches
2266,Rodrygo,BRA,"FW,MF",Real Madrid,La Liga,21,2001,26.4,17,10,3,7,7,4,23,17.4,19,23,0,23,8,25,5,0,Matches
2267,Mads Roerslev,DEN,DF,Brentford,Premier League,23,1999,12.3,22,12,19,3,0,16,33,48.5,17,14,5,9,9,31,38,0,Matches
2268,Agustín Rogel,URU,DF,Hertha BSC,Bundesliga,24,1997,15.8,18,9,13,5,0,11,17,64.7,6,15,8,7,11,29,74,1,Matches
2269,Rogério,BRA,DF,Sassuolo,Serie A,24,1998,33.3,37,21,22,8,7,17,35,48.6,18,32,9,23,37,74,70,0,Matches
2270,Merlin Röhl,GER,"MF,FW",Freiburg,Bundesliga,20,2002,0.6,1,0,1,0,0,0,0,0.0,0,0,0,0,0,1,1,0,Matches
2271,Tony Rölke,GER,FW,Hertha BSC,Bundesliga,19,2003,0.2,0,0,0,0,0,0,0,0.0,0,1,0,1,0,0,1,0,Matches
2272,Filippo Romagna,ITA,DF,Sassuolo,Serie A,25,1997,0.5,0,0,0,0,0,0,0,0.0,0,1,1,0,0,0,2,0,Matches
2273,Alessio Romagnoli,ITA,DF,Lazio,Serie A,27,1995,32.5,33,15,19,14,0,11,22,50.0,11,33,26,7,38,71,108,0,Matches
2274,Simone Romagnoli,ITA,DF,Lecce,Serie A,32,1990,1.9,6,5,3,3,0,2,2,100.0,0,4,1,3,1,7,11,0,Matches
2275,Leonardo Román,ESP,GK,Mallorca,La Liga,22,2000,1.0,0,0,0,0,0,0,0,0.0,0,0,0,0,0,0,0,0,Matches
2276,Cristian Romero,ARG,DF,Tottenham,Premier League,24,1998,26.3,68,36,42,24,2,29,46,63.0,17,40,18,22,44,112,102,3,Matches
2277,Iván Romero,ESP,MF,Sevilla,La Liga,21,2001,0.1,0,0,0,0,0,0,0,0.0,0,0,0,0,0,0,0,0,Matches
2278,Luka Romero,ARG,FW,Lazio,Serie A,17,2004,1.7,0,0,0,0,0,0,3,0.0,3,4,0,4,3,3,1,0,Matches
2279,Oriol Romeu,ESP,MF,Southampton,Premier League,30,1991,0.8,1,0,0,1,0,0,0,0.0,0,1,0,1,1,2,1,0,Matches
2280,Oriol Romeu,ESP,MF,Girona,La Liga,30,1991,32.8,70,38,36,26,8,26,51,51.0,25,48,10,38,37,107,54,0,Matches
2281,Cristiano Ronaldo,POR,FW,Manchester Utd,Premier League,37,1985,5.8,2,2,1,0,1,1,2,50.0,1,0,0,0,1,3,9,0,Matches
2282,Connor Ronan,IRL,MF,Wolves,Premier League,24,1998,0.0,0,0,0,0,0,0,0,0.0,0,0,0,0,0,0,0,0,Matches
2283,Salomón Rondón,VEN,FW,Everton,Premier League,32,1989,1.2,0,0,0,0,0,0,0,0.0,0,1,1,0,0,0,0,0,Matches
2284,Valentin Rongier,FRA,MF,Marseille,Ligue 1,27,1994,33.7,93,59,33,47,13,41,77,53.2,36,50,11,39,54,147,38,1,Matches
2285,Marten de Roon,NED,MF,Atalanta,Serie A,31,1991,32.9,77,39,37,35,5,37,81,45.7,44,37,4,33,36,113,58,0,Matches
2286,Pablo Rosario,NED,"MF,DF",Nice,Ligue 1,25,1997,19.6,46,26,22,20,4,18,34,52.9,16,15,5,10,23,69,32,1,Matches
2287,Francesco Rossi,ITA,GK,Atalanta,Serie A,31,1991,0.0,0,0,0,0,0,0,0,0.0,0,0,0,0,0,0,0,0,Matches
2288,Tom Rothe,GER,DF,Dortmund,Bundesliga,17,2004,0.3,1,1,0,1,0,1,1,100.0,0,0,0,0,1,2,2,0,Matches
2289,Joe Rothwell,ENG,MF,Bournemouth,Premier League,27,1995,11.3,20,13,7,12,1,7,21,33.3,14,14,3,11,9,29,7,0,Matches
2290,Anthony Rouault,FRA,DF,Toulouse,Ligue 1,21,2001,36.8,66,37,54,10,2,30,58,51.7,28,52,26,26,56,122,126,4,Matches
2291,Jérôme Roussillon,FRA,"MF,DF",Wolfsburg,Bundesliga,29,1993,0.2,0,0,0,0,0,0,0,0.0,0,0,0,0,0,0,0,0,Matches
2292,Jérôme Roussillon,FRA,DF,Union Berlin,Bundesliga,29,1993,10.6,16,9,6,8,2,8,12,66.7,4,7,2,5,4,20,22,0,Matches
2293,Nicolò Rovella,ITA,MF,Monza,Serie A,20,2001,19.3,45,29,22,21,2,13,36,36.1,23,20,1,19,40,85,17,0,Matches
2294,Nicolò Rovella,ITA,MF,Juventus,Serie A,20,2001,0.3,1,1,0,1,0,1,1,100.0,0,0,0,0,0,1,0,0,Matches
2295,Amir Rrahmani,KVX,DF,Napoli,Serie A,28,1994,27.2,33,18,20,13,0,17,26,65.4,9,36,20,16,14,47,79,1,Matches
2296,Ruan,BRA,DF,Sassuolo,Serie A,23,1999,19.0,38,26,25,12,1,19,29,65.5,10,29,17,12,24,62,80,3,Matches
2297,Rubén,ESP,"DF,MF",Espanyol,La Liga,21,2001,9.9,30,15,18,9,3,20,29,69.0,9,14,4,10,18,48,18,0,Matches
2298,Antonio Rüdiger,GER,DF,Real Madrid,La Liga,29,1993,26.8,18,16,12,5,1,14,23,60.9,9,23,13,10,19,37,74,0,Matches
2299,Sebastian Rudy,GER,MF,Hoffenheim,Bundesliga,32,1990,8.8,26,12,10,16,0,13,27,48.1,14,27,7,20,11,37,13,0,Matches
2300,Daniele Rugani,ITA,DF,Juventus,Serie A,28,1994,6.3,7,0,6,1,0,4,4,100.0,0,7,5,2,7,14,32,0,Matches
2301,Matteo Ruggeri,ITA,"DF,MF",Atalanta,Serie A,20,2002,9.2,17,12,5,9,3,8,16,50.0,8,14,3,11,12,29,16,0,Matches
2302,Mário Rui,POR,DF,Napoli,Serie A,31,1991,19.4,34,22,17,13,4,20,41,48.8,21,17,4,13,15,49,24,1,Matches
2303,Aitor Ruibal,ESP,"DF,FW",Betis,La Liga,26,1996,16.2,47,29,35,9,3,31,58,53.4,27,17,2,15,24,71,41,0,Matches
2304,Kays Ruiz,MAR,MF,Auxerre,Ligue 1,19,2002,0.7,1,1,1,0,0,0,1,0.0,1,2,1,1,3,4,0,0,Matches
2305,Fabián Ruiz Peña,ESP,MF,Paris S-G,Ligue 1,26,1996,21.0,62,28,25,30,7,43,79,54.4,36,24,1,23,18,80,23,1,Matches
2306,Víctor Ruiz,ESP,DF,Betis,La Liga,33,1989,6.2,5,3,3,2,0,3,3,100.0,0,10,7,3,6,11,34,0,Matches
2307,Gerónimo Rulli,ARG,GK,Villarreal,La Liga,30,1992,14.0,0,0,0,0,0,0,0,0.0,0,1,0,1,1,1,6,2,Matches
2308,Alessandro Russo,ITA,GK,Sassuolo,Serie A,21,2001,1.0,0,0,0,0,0,0,0,0.0,0,0,0,0,0,0,1,1,Matches
2309,Franco Russo,ARG,DF,Mallorca,La Liga,27,1994,1.6,2,1,2,0,0,0,1,0.0,1,5,0,5,3,5,5,0,Matches
2310,Georginio Rutter,FRA,"FW,MF",Leeds United,Premier League,20,2002,3.0,10,9,5,3,2,5,8,62.5,3,5,0,5,3,13,3,0,Matches
2311,Georginio Rutter,FRA,FW,Hoffenheim,Bundesliga,20,2002,11.2,7,4,1,4,2,1,3,33.3,2,10,2,8,5,12,6,0,Matches
2312,Julian Ryerson,NOR,DF,Union Berlin,Bundesliga,24,1997,11.5,28,17,17,10,1,15,25,60.0,10,15,3,12,12,40,19,0,Matches
2313,Julian Ryerson,NOR,DF,Dortmund,Bundesliga,24,1997,15.7,27,15,17,7,3,19,37,51.4,18,13,2,11,8,35,28,0,Matches
2314,Frederik Rønnow,DEN,GK,Union Berlin,Bundesliga,29,1992,29.0,0,0,0,0,0,0,5,0.0,5,0,0,0,0,0,9,1,Matches
2315,José Sá,POR,GK,Wolves,Premier League,29,1993,36.0,1,0,1,0,0,1,1,100.0,0,0,0,0,0,1,10,6,Matches
2316,Youssouf Sabaly,SEN,DF,Betis,La Liga,29,1993,18.7,45,23,29,14,2,22,33,66.7,11,35,8,27,19,64,52,1,Matches
2317,Halid Šabanović,BIH,DF,Angers,Ligue 1,22,1999,7.1,8,6,7,1,0,6,8,75.0,2,8,2,6,8,16,12,0,Matches
2318,Abdelhamid Sabiri,MAR,"MF,FW",Sampdoria,Serie A,25,1996,11.9,18,7,5,9,4,4,13,30.8,9,18,4,14,2,20,5,0,Matches
2319,Marcel Sabitzer,AUT,MF,Manchester Utd,Premier League,28,1994,7.0,12,8,3,8,1,2,11,18.2,9,6,2,4,8,20,11,0,Matches
2320,Marcel Sabitzer,AUT,MF,Bayern Munich,Bundesliga,28,1994,7.0,27,14,11,10,6,10,17,58.8,7,3,0,3,10,37,9,0,Matches
2321,Falaye Sacko,MLI,DF,Montpellier,Ligue 1,27,1995,28.7,46,25,25,15,6,32,51,62.7,19,43,14,29,33,79,75,1,Matches
2322,Umar Sadiq,NGA,FW,Almería,La Liga,25,1997,2.7,0,0,0,0,0,0,1,0.0,1,2,0,2,0,0,3,0,Matches
2323,Umar Sadiq,NGA,FW,Real Sociedad,La Liga,25,1997,0.9,1,1,0,0,1,0,1,0.0,1,2,0,2,0,1,0,0,Matches
2324,Alexis Saelemaekers,BEL,"FW,DF",Milan,Serie A,23,1999,15.6,31,20,12,16,3,19,41,46.3,22,13,1,12,19,50,11,0,Matches
2325,Wesley Saïd,FRA,"FW,MF",Lens,Ligue 1,27,1995,7.2,4,1,1,2,1,2,6,33.3,4,4,0,4,1,5,2,0,Matches
2326,Allan Saint-Maximin,FRA,FW,Newcastle Utd,Premier League,25,1997,12.4,10,3,3,6,1,2,11,18.2,9,4,0,4,5,15,2,0,Matches
2327,Théo Sainte-Luce,FRA,DF,Montpellier,Ligue 1,23,1998,5.9,13,11,8,5,0,7,14,50.0,7,7,2,5,10,23,11,0,Matches
2328,Samuel Sáiz,ESP,MF,Girona,La Liga,31,1991,2.7,2,2,0,2,0,1,2,50.0,1,3,0,3,0,2,1,1,Matches
2329,Bukayo Saka,ENG,FW,Arsenal,Premier League,20,2001,35.3,63,34,22,15,26,20,44,45.5,24,38,0,38,14,77,19,0,Matches
2330,Hamza Sakhi,MAR,MF,Auxerre,Ligue 1,26,1996,18.4,44,22,22,17,5,22,42,52.4,20,16,1,15,25,69,9,0,Matches
2331,Mamadou Sakho,FRA,DF,Montpellier,Ligue 1,32,1990,8.5,9,5,4,5,0,3,5,60.0,2,17,12,5,8,17,35,1,Matches
2332,Jacopo Sala,ITA,MF,Spezia,Serie A,30,1991,1.2,1,0,1,0,0,0,2,0.0,2,2,0,2,1,2,2,0,Matches
2333,Ibrahim Salah,MAR,"FW,MF",Rennes,Ligue 1,20,2001,2.5,8,1,5,3,0,2,15,13.3,13,3,0,3,2,10,0,0,Matches
2334,Mohamed Salah,EGY,FW,Liverpool,Premier League,30,1992,36.6,21,12,4,5,12,10,26,38.5,16,21,0,21,6,27,4,0,Matches
2335,Amine Salama,FRA,"FW,MF",Angers,Ligue 1,22,2000,13.9,11,9,3,7,1,2,12,16.7,10,8,2,6,10,21,2,0,Matches
2336,Kike Salas,ESP,DF,Sevilla,La Liga,20,2002,4.1,1,1,1,0,0,0,0,0.0,0,4,3,1,5,6,23,0,Matches
2337,William Saliba,FRA,DF,Arsenal,Premier League,21,2001,26.8,34,20,23,9,2,15,18,83.3,3,13,10,3,19,53,85,4,Matches
2338,Dikeni Salifou,TOG,MF,Werder Bremen,Bundesliga,19,2003,0.0,0,0,0,0,0,0,0,0.0,0,0,0,0,0,0,0,0,Matches
2339,Mohammed Salisu,GHA,DF,Southampton,Premier League,23,1999,21.9,51,29,33,16,2,24,34,70.6,10,56,25,31,31,82,122,1,Matches
2340,Roland Sallai,HUN,"MF,FW",Freiburg,Bundesliga,25,1997,11.1,11,8,4,3,4,4,10,40.0,6,7,1,6,2,13,11,0,Matches
2341,Yoann Salmier,GUF,DF,Troyes,Ligue 1,29,1992,29.4,51,29,34,12,5,21,35,60.0,14,34,19,15,39,90,124,0,Matches
2342,Salvi,ESP,"FW,MF",Rayo Vallecano,La Liga,31,1991,5.4,13,8,5,5,3,2,8,25.0,6,0,0,0,2,15,2,0,Matches
2343,Lazar Samardzic,SRB,MF,Udinese,Serie A,20,2002,20.5,33,16,9,20,4,17,43,39.5,26,13,0,13,11,44,16,0,Matches
2344,Diadie Samassékou,MLI,"MF,FW",Hoffenheim,Bundesliga,26,1996,0.4,1,0,0,1,0,0,1,0.0,1,0,0,0,0,1,0,0,Matches
2345,Mama Samba Baldé,GNB,FW,Troyes,Ligue 1,26,1995,29.6,46,21,14,21,11,13,28,46.4,15,30,3,27,10,56,13,0,Matches
2346,Brice Samba,FRA,GK,Lens,Ligue 1,28,1994,37.0,1,0,1,0,0,1,2,50.0,1,1,0,1,0,1,12,2,Matches
2347,Albert Sambi Lokonga,BEL,MF,Arsenal,Premier League,22,1999,2.2,1,1,0,0,1,0,2,0.0,2,1,0,1,5,6,2,0,Matches
2348,Albert Sambi Lokonga,BEL,MF,Crystal Palace,Premier League,22,1999,6.0,13,10,7,4,2,8,12,66.7,4,8,3,5,7,20,10,0,Matches
2349,Junior Sambia,FRA,DF,Salernitana,Serie A,25,1996,7.7,12,5,7,4,1,6,10,60.0,4,9,3,6,8,20,16,1,Matches
2350,Samuel,BRA,"FW,MF",Valencia,La Liga,22,1999,32.1,66,43,17,37,12,26,72,36.1,46,34,0,34,18,84,16,0,Matches
2351,Fede San Emeterio,ESP,MF,Cádiz,La Liga,25,1997,20.5,41,22,23,16,2,22,46,47.8,24,34,14,20,17,58,28,0,Matches
2352,Antonio Sanabria,PAR,FW,Torino,Serie A,26,1996,27.0,11,5,3,3,5,1,7,14.3,6,9,2,7,4,15,7,0,Matches
2353,Leandro Sanca,GNB,"FW,MF",Spezia,Serie A,22,2000,0.4,1,1,0,0,1,1,1,100.0,0,0,0,0,0,1,0,0,Matches
2354,Oihan Sancet,ESP,MF,Athletic Club,La Liga,22,2000,28.1,27,16,2,19,6,11,37,29.7,26,10,0,10,4,31,9,1,Matches
2355,Renato Sanches,POR,MF,Paris S-G,Ligue 1,24,1997,8.0,8,1,1,3,4,5,14,35.7,9,13,3,10,9,17,4,0,Matches
2356,Alexis Sánchez,CHI,"FW,MF",Marseille,Ligue 1,33,1988,29.8,27,17,5,16,6,3,24,12.5,21,14,0,14,5,32,6,0,Matches
2357,Antonio Sánchez,ESP,"MF,DF",Mallorca,La Liga,25,1997,12.0,19,8,13,4,2,10,34,29.4,24,18,0,18,22,41,14,1,Matches
2358,Davinson Sánchez,COL,DF,Tottenham,Premier League,26,1996,9.5,24,11,17,6,1,14,20,70.0,6,16,10,6,12,36,41,0,Matches
2359,Iván Sánchez,ESP,"MF,FW",Valladolid,La Liga,29,1992,12.8,20,14,8,8,4,10,27,37.0,17,14,1,13,8,28,4,0,Matches
2360,Javi Sánchez,ESP,DF,Valladolid,La Liga,25,1997,26.6,43,26,27,15,1,17,26,65.4,9,32,22,10,46,89,116,0,Matches
2361,Manu Sánchez,ESP,DF,Osasuna,La Liga,21,2000,23.6,51,35,35,9,7,33,63,52.4,30,33,5,28,14,65,51,0,Matches
2362,Robert Sánchez,ESP,GK,Brighton,Premier League,24,1997,23.0,1,0,1,0,0,0,0,0.0,0,0,0,0,3,4,9,2,Matches
2363,Jadon Sancho,ENG,"FW,MF",Manchester Utd,Premier League,22,2000,18.7,16,10,7,5,4,8,28,28.6,20,25,2,23,7,23,6,0,Matches
2364,Alex Sandro,BRA,DF,Juventus,Serie A,31,1991,19.9,35,20,16,16,3,15,22,68.2,7,27,10,17,15,50,64,1,Matches
2365,Leroy Sané,GER,"MF,FW",Bayern Munich,Bundesliga,26,1996,22.3,38,30,11,19,8,18,36,50.0,18,11,1,10,3,41,1,2,Matches
2366,Sidi Sané,GER,FW,Schalke 04,Bundesliga,19,2003,0.3,1,1,1,0,0,1,1,100.0,0,0,0,0,0,1,0,0,Matches
2367,Morgan Sanson,FRA,MF,Aston Villa,Premier League,27,1994,0.1,2,1,1,1,0,1,1,100.0,0,0,0,0,0,2,0,0,Matches
2368,Morgan Sanson,FRA,MF,Strasbourg,Ligue 1,27,1994,15.8,36,25,10,16,10,17,56,30.4,39,21,1,20,22,58,9,0,Matches
2369,Nicola Sansone,ITA,FW,Bologna,Serie A,30,1991,8.2,12,4,6,4,2,5,10,50.0,5,0,0,0,0,12,4,0,Matches
2370,Baptiste Santamaria,FRA,MF,Rennes,Ligue 1,27,1995,20.1,41,22,13,23,5,21,41,51.2,20,21,5,16,21,62,23,0,Matches
2371,Riccardo Saponara,ITA,FW,Fiorentina,Serie A,30,1991,13.4,10,5,3,6,1,5,9,55.6,4,7,1,6,5,15,9,1,Matches
2372,Pablo Sarabia,ESP,"FW,MF",Wolves,Premier League,30,1992,8.5,12,6,4,5,3,6,15,40.0,9,7,0,7,2,14,4,0,Matches
2373,Pablo Sarabia,ESP,"FW,MF",Paris S-G,Ligue 1,30,1992,4.1,5,4,2,2,1,1,7,14.3,6,3,0,3,2,7,0,0,Matches
2374,Jeremy Sarmiento,ECU,MF,Brighton,Premier League,20,2002,2.0,6,3,4,1,1,2,5,40.0,3,2,0,2,1,7,0,0,Matches
2375,Amin Sarr,SWE,FW,Lyon,Ligue 1,21,2001,6.0,9,6,1,4,4,1,4,25.0,3,2,0,2,0,9,4,0,Matches
2376,Bouna Sarr,SEN,FW,Bayern Munich,Bundesliga,30,1992,0.0,0,0,0,0,0,0,0,0.0,0,0,0,0,0,0,0,0,Matches
2377,Malang Sarr,FRA,DF,Monaco,Ligue 1,23,1999,8.0,6,3,5,1,0,1,5,20.0,4,11,7,4,15,21,29,2,Matches
2378,Mamadou Sarr,FRA,MF,Lyon,Ligue 1,16,2005,0.1,0,0,0,0,0,0,0,0.0,0,0,0,0,0,0,0,0,Matches
2379,Mouhamadou Sarr,SEN,GK,Cremonese,Serie A,25,1997,2.0,0,0,0,0,0,0,0,0.0,0,0,0,0,0,0,2,0,Matches
2380,Martin Satriano,URU,FW,Empoli,Serie A,21,2001,18.9,13,8,5,6,2,6,14,42.9,8,5,0,5,3,16,22,0,Matches
2381,Téji Savanier,FRA,MF,Montpellier,Ligue 1,30,1991,28.3,46,30,16,19,11,23,70,32.9,47,30,2,28,30,76,12,1,Matches
2382,Esteban Saveljich,MNE,FW,Rayo Vallecano,La Liga,31,1991,0.0,0,0,0,0,0,0,0,0.0,0,0,0,0,0,0,0,0,Matches
2383,Stefan Savić,MNE,DF,Atlético Madrid,La Liga,31,1991,21.6,39,26,29,7,3,26,39,66.7,13,17,8,9,33,72,67,2,Matches
2384,Joe Scally,USA,DF,M'Gladbach,Bundesliga,19,2002,24.5,31,20,25,5,1,24,31,77.4,7,17,6,11,8,39,61,0,Matches
2385,Giorgio Scalvini,ITA,DF,Atalanta,Serie A,18,2003,25.9,54,29,30,18,6,29,55,52.7,26,36,13,23,56,110,57,2,Matches
2386,Gianluca Scamacca,ITA,FW,West Ham,Premier League,23,1999,10.3,10,5,1,3,6,2,2,100.0,0,3,0,3,4,14,5,0,Matches
2387,Gustavo Scarpa,BRA,"MF,FW",Nott'ham Forest,Premier League,28,1994,2.0,5,2,3,1,1,2,5,40.0,3,4,0,4,0,5,3,0,Matches
2388,Kevin Schade,GER,FW,Brentford,Premier League,20,2001,8.1,12,8,7,2,3,5,10,50.0,5,7,0,7,4,16,6,0,Matches
2389,Kevin Schade,GER,"FW,MF",Freiburg,Bundesliga,20,2001,2.0,6,4,3,2,1,3,5,60.0,2,0,0,0,0,6,2,0,Matches
2390,András Schäfer,HUN,MF,Union Berlin,Bundesliga,23,1999,9.6,21,9,7,12,2,6,14,42.9,8,12,2,10,4,25,11,0,Matches
2391,Fabian Schär,SUI,DF,Newcastle Utd,Premier League,30,1991,35.6,47,22,31,13,3,24,39,61.5,15,34,19,15,52,99,139,0,Matches
2392,Derry Scherhant,GER,"FW,MF",Hertha BSC,Bundesliga,19,2002,3.2,7,6,3,3,1,4,8,50.0,4,3,0,3,0,7,5,0,Matches
2393,Patrik Schick,CZE,FW,Leverkusen,Bundesliga,26,1996,10.5,0,0,0,0,0,0,1,0.0,1,4,1,3,1,1,7,0,Matches
2394,Kingsley Schindler,GHA,"DF,MF",Köln,Bundesliga,29,1993,12.1,23,12,13,8,2,18,28,64.3,10,14,2,12,15,38,24,0,Matches
2395,Xaver Schlager,AUT,MF,RB Leipzig,Bundesliga,24,1997,16.7,41,24,13,26,2,20,43,46.5,23,19,2,17,17,58,23,0,Matches
2396,Keven Schlotterbeck,GER,DF,Freiburg,Bundesliga,25,1997,0.2,0,0,0,0,0,0,0,0.0,0,1,1,0,2,2,2,0,Matches
2397,Keven Schlotterbeck,GER,DF,Bochum,Bundesliga,25,1997,8.2,17,9,12,5,0,9,11,81.8,2,11,5,6,14,31,49,0,Matches
2398,Nico Schlotterbeck,GER,DF,Dortmund,Bundesliga,22,1999,25.0,59,34,34,24,1,37,53,69.8,16,38,21,17,32,91,71,1,Matches
2399,Jeffrey Schlupp,GHA,"MF,FW",Crystal Palace,Premier League,29,1992,28.1,66,46,28,29,9,22,43,51.2,21,39,8,31,23,89,38,0,Matches
2400,Kasper Schmeichel,DEN,GK,Nice,Ligue 1,35,1986,36.0,1,0,1,0,0,1,4,25.0,3,1,0,1,1,2,11,1,Matches
2401,Jonathan Schmid,FRA,DF,Freiburg,Bundesliga,32,1990,0.5,1,1,1,0,0,0,0,0.0,0,1,0,1,1,2,1,1,Matches
2402,Romano Schmid,AUT,"MF,FW",Werder Bremen,Bundesliga,22,2000,16.9,24,15,5,13,6,10,22,45.5,12,21,3,18,7,31,12,0,Matches
2403,Kenneth Schmidt,GER,DF,Freiburg,Bundesliga,20,2002,2.8,6,3,4,2,0,5,6,83.3,1,4,2,2,0,6,2,0,Matches
2404,Niklas Schmidt,GER,MF,Werder Bremen,Bundesliga,24,1998,12.1,25,10,12,11,2,13,28,46.4,15,10,0,10,5,30,12,0,Matches
2405,Benno Schmitz,GER,DF,Köln,Bundesliga,27,1994,26.9,64,42,31,28,5,42,82,51.2,40,34,4,30,26,90,57,0,Matches
2406,Jerdy Schouten,NED,MF,Bologna,Serie A,25,1997,27.9,63,38,28,33,2,27,49,55.1,22,40,17,23,40,103,43,1,Matches
2407,Perr Schuurs,NED,DF,Torino,Serie A,22,1999,25.8,51,25,29,17,5,14,26,53.8,12,28,16,12,28,79,102,0,Matches
2408,Marvin Schwäbe,GER,GK,Köln,Bundesliga,27,1995,34.0,1,0,1,0,0,1,1,100.0,0,0,0,0,2,3,8,2,Matches
2409,Alexander Schwolow,GER,GK,Schalke 04,Bundesliga,30,1992,22.6,0,0,0,0,0,0,2,0.0,2,0,0,0,1,1,6,3,Matches
2410,Manuel Sebastián,ESP,MF,Sevilla,La Liga,18,2004,1.7,7,4,3,3,1,5,8,62.5,3,0,0,0,0,7,2,0,Matches
2411,Demba Seck,SEN,"MF,FW",Torino,Serie A,21,2001,5.8,5,2,3,2,0,2,3,66.7,1,3,1,2,1,6,1,0,Matches
2412,Haris Seferović,SUI,FW,Celta Vigo,La Liga,30,1992,9.9,6,3,1,4,1,3,8,37.5,5,7,1,6,1,7,6,1,Matches
2413,Telasco Segovia,VEN,MF,Sampdoria,Serie A,19,2003,0.0,0,0,0,0,0,0,0,0.0,0,0,0,0,0,0,0,0,Matches
2414,Jacopo Segre,ITA,DF,Torino,Serie A,25,1997,0.2,0,0,0,0,0,0,0,0.0,0,0,0,0,0,0,0,0,Matches
2415,Paul Seguin,GER,MF,Union Berlin,Bundesliga,27,1995,7.7,17,8,9,4,4,8,18,44.4,10,6,0,6,6,23,7,0,Matches
2416,Alidu Seidu,GHA,DF,Clermont Foot,Ligue 1,22,2000,27.3,52,31,35,14,3,31,51,60.8,20,28,14,14,52,104,50,2,Matches
2417,Davie Selke,GER,FW,Hertha BSC,Bundesliga,27,1995,3.1,2,1,1,1,0,0,1,0.0,1,3,1,2,1,3,5,0,Matches
2418,Davie Selke,GER,FW,Köln,Bundesliga,27,1995,9.7,0,0,0,0,0,0,4,0.0,4,4,1,3,0,0,11,0,Matches
2419,Matz Sels,BEL,GK,Strasbourg,Ligue 1,30,1992,38.0,4,3,4,0,0,4,4,100.0,0,0,0,0,4,8,23,0,Matches
2420,Nélson Semedo,POR,DF,Wolves,Premier League,28,1993,29.2,71,42,48,19,4,33,64,51.6,31,42,15,27,29,100,83,2,Matches
2421,Vivaldo Semedo,POR,"FW,MF",Udinese,Serie A,17,2005,0.4,0,0,0,0,0,0,0,0.0,0,1,0,1,0,0,1,0,Matches
2422,Antoine Semenyo,GHA,"FW,MF",Bournemouth,Premier League,22,2000,2.9,1,0,0,0,1,1,6,16.7,5,10,1,9,2,3,4,0,Matches
2423,Marvin Senaya,TOG,DF,Strasbourg,Ligue 1,21,2001,0.1,0,0,0,0,0,0,1,0.0,1,1,0,1,0,0,1,0,Matches
2424,Marcos Senesi,ARG,DF,Bournemouth,Premier League,25,1997,27.7,50,35,28,22,0,23,43,53.5,20,38,20,18,43,93,146,2,Matches
2425,Stefano Sensi,ITA,MF,Monza,Serie A,26,1995,18.0,41,26,25,13,3,18,48,37.5,30,13,3,10,20,61,4,0,Matches
2426,Jaime Seoane,ESP,"MF,FW",Getafe,La Liga,25,1997,3.6,10,4,3,4,3,2,8,25.0,6,7,3,4,1,11,2,0,Matches
2427,Luigi Sepe,ITA,GK,Salernitana,Serie A,31,1991,17.0,0,0,0,0,0,0,1,0.0,1,0,0,0,0,0,0,0,Matches
2428,Suat Serdar,GER,MF,Hertha BSC,Bundesliga,25,1997,22.5,51,23,14,30,7,20,41,48.8,21,48,12,36,29,80,24,0,Matches
2429,Leonardo Sernicola,ITA,DF,Cremonese,Serie A,25,1997,25.7,45,33,25,13,7,29,43,67.4,14,23,6,17,38,83,55,0,Matches
2430,Ryan Sessegnon,ENG,DF,Tottenham,Premier League,22,2000,9.0,16,11,9,7,0,6,12,50.0,6,8,1,7,6,22,17,1,Matches
2431,Stephan El Shaarawy,ITA,"DF,MF",Roma,Serie A,29,1992,16.9,21,9,8,10,3,6,22,27.3,16,11,1,10,15,36,11,0,Matches
2432,Eniss Shabani,GER,MF,Mainz 05,Bundesliga,19,2003,0.1,0,0,0,0,0,0,0,0.0,0,0,0,0,0,0,0,0,Matches
2433,Luke Shaw,ENG,DF,Manchester Utd,Premier League,27,1995,28.4,55,36,31,22,2,32,45,71.1,13,51,17,34,36,91,55,2,Matches
2434,Jonjo Shelvey,ENG,MF,Newcastle Utd,Premier League,30,1992,0.4,1,0,1,0,0,0,1,0.0,1,1,0,1,0,1,0,0,Matches
2435,Jonjo Shelvey,ENG,MF,Nott'ham Forest,Premier League,30,1992,6.0,2,1,0,1,1,1,9,11.1,8,7,2,5,5,7,10,1,Matches
2436,Eldor Shomurodov,UZB,FW,Spezia,Serie A,27,1995,9.0,5,5,3,1,1,2,11,18.2,9,5,1,4,3,8,4,0,Matches
2437,Eldor Shomurodov,UZB,FW,Roma,Serie A,27,1995,1.3,1,0,1,0,0,0,2,0.0,2,1,0,1,1,2,0,0,Matches
2438,Kaj Sierhuis,NED,"FW,MF",Reims,Ligue 1,24,1998,2.4,3,3,1,0,2,0,5,0.0,5,3,1,2,1,4,2,0,Matches
2439,Vincent Sierro,SUI,MF,Toulouse,Ligue 1,26,1995,7.4,19,11,9,9,1,11,29,37.9,18,12,3,9,4,23,11,1,Matches
2440,Kiliann Sildillia,FRA,"DF,MF",Freiburg,Bundesliga,20,2002,22.0,33,20,10,19,4,18,30,60.0,12,24,9,15,21,54,47,1,Matches
2441,André Silva,POR,FW,RB Leipzig,Bundesliga,26,1995,19.3,12,6,2,5,5,3,8,37.5,5,11,1,10,3,15,3,0,Matches
2442,Bernardo Silva,POR,"MF,FW",Manchester City,Premier League,27,1994,24.5,44,23,11,25,8,18,44,40.9,26,23,6,17,16,60,6,0,Matches
2443,Caio Henrique Oliveira Silva,BRA,DF,Monaco,Ligue 1,25,1997,32.2,74,51,42,28,4,44,76,57.9,32,28,8,20,26,100,68,1,Matches
2444,David Silva,ESP,MF,Real Sociedad,La Liga,36,1986,21.5,36,21,11,18,7,11,19,57.9,8,17,2,15,15,51,16,0,Matches
2445,Rui Silva,POR,GK,Betis,La Liga,28,1994,26.0,4,1,4,0,0,4,4,100.0,0,0,0,0,0,4,12,1,Matches
2446,Thiago Silva,BRA,DF,Chelsea,Premier League,37,1984,26.1,41,27,24,17,0,21,31,67.7,10,38,29,9,34,75,111,2,Matches
2447,Marco Silvestri,ITA,GK,Udinese,Serie A,31,1991,38.0,2,1,2,0,0,2,3,66.7,1,0,0,0,1,3,15,1,Matches
2448,Abdallah Sima,SEN,FW,Angers,Ligue 1,21,2001,20.4,22,13,4,15,3,7,19,36.8,12,8,0,8,4,26,19,0,Matches
2449,Mohamed Simakan,FRA,DF,RB Leipzig,Bundesliga,22,2000,16.2,21,14,12,5,4,14,21,66.7,7,21,4,17,16,37,55,0,Matches
2450,Giovanni Simeone,ARG,FW,Napoli,Serie A,27,1995,4.5,12,3,3,5,4,3,8,37.5,5,2,1,1,1,13,4,0,Matches
2451,Ellis Simms,ENG,FW,Everton,Premier League,21,2001,2.5,0,0,0,0,0,0,0,0.0,0,0,0,0,0,0,1,0,Matches
2452,Simo,ESP,DF,Espanyol,La Liga,17,2005,1.6,3,1,3,0,0,2,3,66.7,1,5,4,1,0,3,3,0,Matches
2453,Moses Simon,NGA,"FW,MF",Nantes,Ligue 1,27,1995,26.1,18,9,6,7,5,7,15,46.7,8,14,1,13,11,29,3,0,Matches
2454,Unai Simón,ESP,GK,Athletic Club,La Liga,25,1997,30.5,2,0,2,0,0,1,1,100.0,0,1,0,1,0,2,9,3,Matches
2455,Lassine Sinayoko,MLI,"MF,FW",Auxerre,Ligue 1,22,1999,17.4,33,15,14,12,7,21,40,52.5,19,12,0,12,18,51,17,0,Matches
2456,Wilfried Singo,CIV,DF,Torino,Serie A,21,2000,22.7,27,17,14,10,3,12,19,63.2,7,15,2,13,12,39,33,1,Matches
2457,Luis Sinisterra,COL,FW,Leeds United,Premier League,23,1999,9.6,21,14,8,9,4,11,18,61.1,7,11,1,10,8,29,2,0,Matches
2458,Daley Sinkgraven,NED,"DF,MF",Leverkusen,Bundesliga,27,1995,3.8,10,7,7,3,0,7,9,77.8,2,8,4,4,5,15,7,0,Matches
2459,Tobias Sippel,GER,GK,M'Gladbach,Bundesliga,34,1988,5.7,0,0,0,0,0,0,0,0.0,0,0,0,0,0,0,1,1,Matches
2460,Hugo Siquet,BEL,DF,Freiburg,Bundesliga,20,2002,0.2,2,2,2,0,0,2,2,100.0,0,1,0,1,0,2,0,0,Matches
2461,Salvatore Sirigu,ITA,GK,Fiorentina,Serie A,35,1987,1.0,0,0,0,0,0,0,0,0.0,0,0,0,0,0,0,1,0,Matches
2462,Ibrahima Sissoko,FRA,MF,Strasbourg,Ligue 1,24,1997,14.6,40,22,18,17,5,22,42,52.4,20,20,6,14,10,50,19,0,Matches
2463,Moussa Sissoko,FRA,MF,Nantes,Ligue 1,32,1989,21.3,26,16,16,7,3,12,18,66.7,6,22,5,17,16,42,17,0,Matches
2464,Tim Skarke,GER,"DF,MF",Union Berlin,Bundesliga,25,1996,0.6,1,1,0,0,1,0,0,0.0,0,1,0,1,0,1,0,0,Matches
2465,Tim Skarke,GER,"FW,MF",Schalke 04,Bundesliga,25,1996,4.9,13,7,3,8,2,8,11,72.7,3,5,0,5,0,13,4,0,Matches
2466,Ellyes Skhiri,TUN,MF,Köln,Bundesliga,27,1995,31.7,79,44,29,42,8,26,66,39.4,40,52,12,40,56,135,48,0,Matches
2467,Oliver Skipp,ENG,MF,Tottenham,Premier League,21,2000,16.6,34,17,18,15,1,16,33,48.5,17,17,8,9,17,51,19,1,Matches
2468,Leo Skiri Østigård,NOR,DF,Napoli,Serie A,22,1999,4.7,4,1,3,1,0,1,1,100.0,0,3,3,0,6,10,18,1,Matches
2469,Łukasz Skorupski,POL,GK,Bologna,Serie A,31,1991,37.0,2,1,2,0,0,1,2,50.0,1,0,0,0,0,2,19,2,Matches
2470,Robert Skov,DEN,DF,Hoffenheim,Bundesliga,26,1996,15.0,22,11,14,7,1,10,26,38.5,16,22,8,14,8,30,20,2,Matches
2471,Milan Škriniar,SVK,DF,Inter,Serie A,27,1995,19.7,29,18,14,11,4,18,32,56.3,14,18,13,5,13,42,46,3,Matches
2472,Naatan Skyttä,FIN,MF,Toulouse,Ligue 1,20,2002,0.3,0,0,0,0,0,0,0,0.0,0,0,0,0,1,1,0,0,Matches
2473,Islam Slimani,ALG,FW,Brest,Ligue 1,34,1988,11.0,5,3,2,2,1,0,3,0.0,3,2,0,2,1,6,11,0,Matches
2474,Chris Smalling,ENG,DF,Roma,Serie A,32,1989,31.2,26,15,16,10,0,13,21,61.9,8,51,36,15,43,69,123,0,Matches
2475,Adam Smith,ENG,DF,Bournemouth,Premier League,31,1991,32.7,49,29,27,19,3,29,60,48.3,31,30,13,17,25,74,81,1,Matches
2476,Emile Smith Rowe,ENG,"MF,FW",Arsenal,Premier League,22,2000,1.9,1,1,1,0,0,1,3,33.3,2,1,0,1,0,1,2,0,Matches
2477,Hrvoje Smolčić,CRO,DF,Eint Frankfurt,Bundesliga,21,2000,5.2,8,7,6,2,0,5,10,50.0,5,11,4,7,6,14,38,0,Matches
2478,Cédric Soares,POR,DF,Arsenal,Premier League,30,1991,0.3,0,0,0,0,0,0,1,0.0,1,1,0,1,0,0,1,0,Matches
2479,Cédric Soares,POR,DF,Fulham,Premier League,30,1991,2.2,8,5,4,3,1,3,3,100.0,0,3,1,2,1,9,5,0,Matches
2480,Danilo Soares,BRA,DF,Bochum,Bundesliga,30,1991,19.6,72,46,42,23,7,43,72,59.7,29,29,6,23,30,102,56,1,Matches
2481,Eduard Sobol,UKR,DF,Strasbourg,Ligue 1,27,1995,9.7,19,10,10,6,3,9,13,69.2,4,10,1,9,8,27,19,0,Matches
2482,Rubén Sobrino,ESP,"MF,FW",Cádiz,La Liga,30,1992,27.4,55,37,29,17,9,23,56,41.1,33,33,3,30,24,79,20,1,Matches
2483,Alex Sola,ESP,DF,Real Sociedad,La Liga,23,1999,3.9,18,9,14,3,1,7,10,70.0,3,7,2,5,7,25,10,0,Matches
2484,Dominic Solanke,ENG,"FW,MF",Bournemouth,Premier League,24,1997,31.8,15,9,8,3,4,5,22,22.7,17,26,7,19,6,21,46,0,Matches
2485,Augusto Solari,ARG,MF,Celta Vigo,La Liga,30,1992,2.9,10,6,6,3,1,3,11,27.3,8,5,0,5,4,14,3,0,Matches
2486,Ola Solbakken,NOR,"MF,FW",Roma,Serie A,23,1998,5.6,2,2,1,1,0,2,7,28.6,5,2,0,2,2,4,8,0,Matches
2487,Nikola Soldo,CRO,DF,Köln,Bundesliga,21,2001,6.6,15,9,8,7,0,7,11,63.6,4,7,6,1,7,22,28,0,Matches
2488,Carlos Soler,ESP,MF,Valencia,La Liga,25,1997,2.7,2,0,0,1,1,2,3,66.7,1,1,0,1,0,2,2,0,Matches
2489,Carlos Soler,ESP,MF,Paris S-G,Ligue 1,25,1997,13.2,20,12,6,10,4,10,19,52.6,9,12,4,8,4,24,6,0,Matches
2490,François-Joseph Sollacaro,FRA,GK,Ajaccio,Ligue 1,28,1994,6.0,0,0,0,0,0,0,0,0.0,0,0,0,0,0,0,2,2,Matches
2491,Manor Solomon,ISR,FW,Fulham,Premier League,23,1999,6.4,20,12,12,6,2,9,16,56.3,7,8,0,8,5,25,3,0,Matches
2492,Yann Sommer,SUI,GK,Bayern Munich,Bundesliga,33,1988,19.0,0,0,0,0,0,0,0,0.0,0,0,0,0,1,1,5,1,Matches
2493,Yann Sommer,SUI,GK,M'Gladbach,Bundesliga,33,1988,10.0,1,0,1,0,0,1,1,100.0,0,0,0,0,0,1,8,0,Matches
2494,Brandon Soppy,FRA,DF,Udinese,Serie A,20,2002,1.0,1,1,0,1,0,0,0,0.0,0,4,0,4,1,2,1,0,Matches
2495,Brandon Soppy,FRA,DF,Atalanta,Serie A,20,2002,7.1,8,5,4,4,0,3,9,33.3,6,10,0,10,3,11,7,0,Matches
2496,David Soria,ESP,GK,Getafe,La Liga,29,1993,38.0,0,0,0,0,0,0,1,0.0,1,0,0,0,1,1,20,4,Matches
2497,Roberto Soriano,ITA,"FW,MF",Bologna,Serie A,31,1991,14.7,31,16,9,16,6,13,25,52.0,12,23,2,21,6,37,14,0,Matches
2498,Borna Sosa,CRO,DF,Stuttgart,Bundesliga,24,1998,21.7,27,21,18,8,1,21,32,65.6,11,20,5,15,19,46,37,0,Matches
2499,Joaquin Sosa,URU,DF,Bologna,Serie A,20,2002,7.6,6,2,5,1,0,4,18,22.2,14,5,3,2,6,12,31,0,Matches
2500,Hugo Sotelo,ESP,MF,Celta Vigo,La Liga,18,2003,0.2,0,0,0,0,0,0,0,0.0,0,0,0,0,0,0,0,0,Matches
2501,Florian Sotoca,FRA,"MF,FW",Lens,Ligue 1,31,1990,33.9,39,19,11,17,11,15,40,37.5,25,41,2,39,29,68,51,0,Matches
2502,Riccardo Sottil,ITA,FW,Fiorentina,Serie A,23,1999,9.3,4,3,2,0,2,2,5,40.0,3,2,0,2,0,4,0,0,Matches
2503,Tomáš Souček,CZE,MF,West Ham,Premier League,27,1995,31.3,77,37,41,29,7,28,58,48.3,30,42,17,25,53,130,71,3,Matches
2504,Matìas Soulé,ARG,"MF,FW",Juventus,Serie A,19,2003,4.7,7,4,3,2,2,5,7,71.4,2,7,1,6,3,10,3,0,Matches
2505,Moussa Soumano,FRA,FW,Ajaccio,Ligue 1,17,2005,5.5,2,2,0,1,1,0,6,0.0,6,2,0,2,0,2,0,0,Matches
2506,Adama Soumaoro,FRA,DF,Bologna,Serie A,30,1992,20.7,25,17,11,12,2,5,7,71.4,2,18,13,5,15,40,75,1,Matches
2507,Boubakary Soumaré,FRA,MF,Leicester City,Premier League,23,1999,18.1,57,34,29,26,2,23,43,53.5,20,15,4,11,33,90,27,1,Matches
2508,Arnaud Souquet,FRA,"DF,FW",Montpellier,Ligue 1,30,1992,4.0,22,16,13,7,2,11,14,78.6,3,8,3,5,4,26,4,0,Matches
2509,Dyego Sousa,POR,FW,Almería,La Liga,32,1989,5.9,10,6,5,4,1,4,5,80.0,1,4,2,2,1,11,14,0,Matches
2510,Harry Souttar,AUS,DF,Leicester City,Premier League,23,1998,11.0,15,9,10,5,0,7,18,38.9,11,16,12,4,12,27,45,0,Matches
2511,Vinicius Souza,BRA,MF,Espanyol,La Liga,23,1999,27.0,99,66,41,45,13,33,59,55.9,26,31,14,17,48,147,50,1,Matches
2512,Djibril Sow,SUI,MF,Eint Frankfurt,Bundesliga,25,1997,29.4,41,25,13,25,3,22,44,50.0,22,22,4,18,28,69,23,0,Matches
2513,Çağlar Söyüncü,TUR,DF,Leicester City,Premier League,26,1996,5.9,14,9,10,4,0,7,10,70.0,3,9,8,1,7,21,30,0,Matches
2514,Kevin Spadanuda,SUI,"MF,FW",Ajaccio,Ligue 1,25,1997,11.8,29,18,15,9,5,12,33,36.4,21,18,0,18,11,40,5,0,Matches
2515,Djed Spence,ENG,"FW,DF",Tottenham,Premier League,21,2000,0.1,0,0,0,0,0,0,0,0.0,0,0,0,0,0,0,0,0,Matches
2516,Djed Spence,ENG,DF,Rennes,Ligue 1,21,2000,6.4,14,6,8,2,4,11,18,61.1,7,10,3,7,4,18,15,0,Matches
2517,Stijn Spierings,NED,MF,Toulouse,Ligue 1,26,1996,34.7,95,67,37,49,9,43,101,42.6,58,49,11,38,53,148,44,0,Matches
2518,Leonardo Spinazzola,ITA,DF,Roma,Serie A,29,1993,18.4,15,8,7,6,2,8,23,34.8,15,13,3,10,9,24,25,0,Matches
2519,Marco Sportiello,ITA,GK,Atalanta,Serie A,30,1992,14.9,1,0,1,0,0,1,3,33.3,2,0,0,0,0,1,2,0,Matches
2520,Jack Stacey,ENG,DF,Bournemouth,Premier League,26,1996,3.3,5,4,3,1,1,2,5,40.0,3,3,1,2,5,10,15,0,Matches
2521,Anton Stach,GER,MF,Mainz 05,Bundesliga,23,1998,23.0,27,21,10,15,2,16,38,42.1,22,28,2,26,41,68,25,0,Matches
2522,Kostas Stafylidis,GRE,"DF,MF",Bochum,Bundesliga,28,1993,11.6,27,16,13,8,6,10,24,41.7,14,21,8,13,20,47,31,1,Matches
2523,Jens Stage,DEN,MF,Werder Bremen,Bundesliga,25,1996,20.6,34,17,15,18,1,10,37,27.0,27,34,11,23,16,50,37,0,Matches
2524,Veit Stange,GER,MF,Hertha BSC,Bundesliga,18,2004,0.1,1,1,1,0,0,1,1,100.0,0,0,0,0,0,1,0,0,Matches
2525,Josip Stanišić,CRO,DF,Bayern Munich,Bundesliga,22,2000,6.4,19,11,14,2,3,12,17,70.6,5,9,1,8,7,26,11,3,Matches
2526,Junior Stanislas,ENG,MF,Bournemouth,Premier League,32,1989,0.7,0,0,0,0,0,0,0,0.0,0,2,1,1,0,0,0,0,Matches
2527,Jay Stansfield,ENG,FW,Fulham,Premier League,19,2002,1.0,0,0,0,0,0,0,2,0.0,2,4,1,3,1,1,1,0,Matches
2528,Niklas Stark,GER,DF,Werder Bremen,Bundesliga,27,1995,23.1,56,36,29,24,3,27,42,64.3,15,24,13,11,37,93,110,0,Matches
2529,Jason Steele,ENG,GK,Brighton,Premier League,31,1990,15.0,0,0,0,0,0,0,1,0.0,1,0,0,0,0,0,6,1,Matches
2530,Calvin Stengs,NED,FW,Nice,Ligue 1,23,1998,2.4,2,2,1,0,1,1,2,50.0,1,0,0,0,0,2,0,0,Matches
2531,Pascal Stenzel,GER,DF,Stuttgart,Bundesliga,26,1996,3.7,12,8,8,4,0,5,9,55.6,4,9,2,7,5,17,6,0,Matches
2532,Jack Stephens,ENG,DF,Southampton,Premier League,28,1994,0.5,2,2,2,0,0,1,1,100.0,0,1,1,0,1,3,2,0,Matches
2533,Jack Stephens,ENG,DF,Bournemouth,Premier League,28,1994,13.0,15,11,10,4,1,6,10,60.0,4,23,16,7,16,31,53,0,Matches
2534,Raheem Sterling,ENG,"FW,MF",Chelsea,Premier League,27,1994,21.0,18,10,5,4,9,8,14,57.1,6,17,0,17,2,20,5,0,Matches
2535,Angelo Stiller,GER,MF,Hoffenheim,Bundesliga,21,2001,7.8,26,12,9,13,4,8,12,66.7,4,12,2,10,10,36,14,0,Matches
2536,Lars Stindl,GER,"FW,MF",M'Gladbach,Bundesliga,33,1988,19.3,24,14,4,17,3,10,28,35.7,18,24,5,19,11,35,19,0,Matches
2537,Kevin Stöger,AUT,MF,Bochum,Bundesliga,28,1993,28.9,84,45,38,32,14,31,94,33.0,63,27,4,23,26,110,21,1,Matches
2538,Petar Stojanović,SVN,DF,Empoli,Serie A,26,1995,17.0,42,22,28,10,4,26,43,60.5,17,17,5,12,11,53,55,0,Matches
2539,John Stones,ENG,"DF,MF",Manchester City,Premier League,28,1994,20.5,23,13,11,8,4,7,10,70.0,3,17,10,7,9,32,40,0,Matches
2540,Jørgen Strand Larsen,NOR,FW,Celta Vigo,La Liga,22,2000,18.9,15,7,3,5,7,7,30,23.3,23,14,5,9,3,18,24,0,Matches
2541,Tony Strata,FRA,"MF,DF",Ajaccio,Ligue 1,17,2004,1.5,4,3,4,0,0,4,5,80.0,1,2,0,2,1,5,7,0,Matches
2542,Gabriel Strefezza,0,"DF,FW",Lecce,Serie A,25,1997,27.1,0,27,0,0,0,0,0,0.0,0,0,0,0,16,0,0,0,Matches
2543,Dávid Strelec,SVK,FW,Spezia,Serie A,21,2001,1.9,2,2,0,1,1,2,2,100.0,0,0,0,0,0,2,0,0,Matches
2544,Pascal Struijk,NED,DF,Leeds United,Premier League,22,1999,24.4,84,57,43,31,10,49,75,65.3,26,32,12,20,32,116,70,1,Matches
2545,Cristhian Stuani,URU,FW,Girona,La Liga,35,1986,12.1,13,6,2,7,4,5,14,35.7,9,10,0,10,2,15,5,0,Matches
2546,Damián Suárez,URU,"DF,MF",Getafe,La Liga,34,1988,21.6,49,33,23,19,7,26,48,54.2,22,40,0,40,15,64,36,0,Matches
2547,Denis Suárez,ESP,"MF,FW",Espanyol,La Liga,28,1994,10.5,26,20,12,12,2,13,45,28.9,32,11,1,10,5,31,4,0,Matches
2548,Mario Suárez,ESP,"MF,DF",Rayo Vallecano,La Liga,35,1987,0.1,0,0,0,0,0,0,0,0.0,0,1,0,1,0,0,0,0,Matches
2549,Gabriel Suazo,CHI,DF,Toulouse,Ligue 1,24,1997,14.0,38,22,20,15,3,29,63,46.0,34,21,5,16,22,60,24,1,Matches
2550,Isaac Success,NGA,FW,Udinese,Serie A,26,1996,20.2,8,4,2,5,1,3,8,37.5,5,13,2,11,4,12,18,0,Matches
2551,Niklas Süle,GER,DF,Dortmund,Bundesliga,26,1995,23.5,25,19,18,3,4,14,23,60.9,9,28,19,9,17,42,53,0,Matches
2552,Ibrahim Sulemana,GHA,MF,Hellas Verona,Serie A,19,2003,7.2,19,13,10,7,2,6,12,50.0,6,8,2,6,14,33,15,0,Matches
2553,Kamaldeen Sulemana,GHA,"FW,MF",Southampton,Premier League,20,2002,10.7,15,9,4,7,4,4,14,28.6,10,16,0,16,6,21,6,0,Matches
2554,Kamaldeen Sulemana,GHA,"FW,MF",Rennes,Ligue 1,20,2002,3.6,6,3,1,4,1,1,5,20.0,4,2,0,2,4,10,2,0,Matches
2555,Crysencio Summerville,NED,FW,Leeds United,Premier League,20,2001,15.8,30,20,14,14,2,11,23,47.8,12,20,2,18,13,43,11,0,Matches
2556,Ivan Šunjić,CRO,MF,Hertha BSC,Bundesliga,25,1996,11.0,38,20,16,21,1,16,24,66.7,8,17,5,12,13,51,19,1,Matches
2557,Sam Surridge,ENG,FW,Nott'ham Forest,Premier League,24,1998,3.6,5,0,1,3,1,1,4,25.0,3,5,2,3,0,5,7,0,Matches
2558,Suso,ESP,"MF,FW",Sevilla,La Liga,28,1993,11.8,16,10,5,7,4,10,22,45.5,12,7,1,6,2,18,3,0,Matches
2559,Yuito Suzuki,JPN,"FW,MF",Strasbourg,Ligue 1,20,2001,0.4,0,0,0,0,0,0,0,0.0,0,3,0,3,0,0,0,0,Matches
2560,Mattias Svanberg,SWE,"MF,FW",Wolfsburg,Bundesliga,23,1999,20.4,25,16,8,16,1,10,30,33.3,20,27,5,22,21,46,25,1,Matches
2561,Mile Svilar,SRB,GK,Roma,Serie A,22,1999,3.0,0,0,0,0,0,0,0,0.0,0,0,0,0,0,0,1,0,Matches
2562,Williot Swedberg,SWE,MF,Celta Vigo,La Liga,18,2004,0.6,3,1,1,0,2,0,0,0.0,0,2,0,2,0,3,1,0,Matches
2563,Issiaga Sylla,GUI,DF,Montpellier,Ligue 1,28,1994,14.5,28,16,19,8,1,15,31,48.4,16,19,3,16,32,60,35,0,Matches
2564,Issiaga Sylla,GUI,DF,Toulouse,Ligue 1,28,1994,15.2,28,15,14,9,5,15,34,44.1,19,15,5,10,38,66,38,0,Matches
2565,Wojciech Szczęsny,POL,GK,Juventus,Serie A,32,1990,27.5,1,0,1,0,0,0,1,0.0,1,0,0,0,0,1,7,0,Matches
2566,Dominik Szoboszlai,HUN,"MF,FW",RB Leipzig,Bundesliga,21,2000,27.2,45,28,12,20,13,17,42,40.5,25,43,2,41,17,62,27,0,Matches
2567,Alexander Sørloth,NOR,FW,Real Sociedad,La Liga,26,1995,26.5,18,9,3,6,9,7,14,50.0,7,15,1,14,2,20,26,1,Matches
2568,Alexander Sørloth,NOR,FW,RB Leipzig,Bundesliga,26,1995,0.1,0,0,0,0,0,0,0,0.0,0,0,0,0,0,0,0,0,Matches
2569,Nicolás Tagliafico,ARG,DF,Lyon,Ligue 1,29,1992,33.2,91,53,36,41,14,50,78,64.1,28,45,11,34,57,148,47,0,Matches
2570,Jonathan Tah,GER,DF,Leverkusen,Bundesliga,26,1996,27.6,25,12,21,4,0,12,18,66.7,6,30,18,12,40,65,118,0,Matches
2571,Benjamin Tahirovic,BIH,MF,Roma,Serie A,19,2003,3.9,8,5,5,2,1,4,12,33.3,8,9,4,5,3,11,3,0,Matches
2572,Waniss Taibi,FRA,MF,Angers,Ligue 1,20,2002,2.1,9,5,4,4,1,2,4,50.0,2,1,0,1,2,11,2,0,Matches
2573,Flavien Tait,FRA,MF,Rennes,Ligue 1,29,1993,18.7,30,15,8,17,5,19,42,45.2,23,16,4,12,20,50,12,0,Matches
2574,Montassar Talbi,TUN,DF,Lorient,Ligue 1,24,1998,38.0,53,25,40,13,0,22,35,62.9,13,55,34,21,40,93,190,3,Matches
2575,Thibault Tamas,FRA,DF,Montpellier,Ligue 1,21,2001,0.1,0,0,0,0,0,0,0,0.0,0,0,0,0,1,1,0,0,Matches
2576,Adrien Tameze,CMR,MF,Hellas Verona,Serie A,28,1994,33.7,51,30,21,26,4,28,63,44.4,35,51,14,37,37,88,55,2,Matches
2577,Japhet Tanganga,ENG,DF,Tottenham,Premier League,23,1999,1.6,3,2,3,0,0,1,5,20.0,4,1,0,1,2,5,8,0,Matches
2578,Renato Tapia,PER,"MF,DF",Celta Vigo,La Liga,27,1995,16.1,47,25,21,21,5,18,37,48.6,19,29,11,18,19,66,37,0,Matches
2579,Edmond Tapsoba,BFA,DF,Leverkusen,Bundesliga,23,1999,31.9,51,30,35,12,4,30,42,71.4,12,40,17,23,36,87,109,1,Matches
2580,Florian Tardieu,FRA,MF,Troyes,Ligue 1,30,1992,11.2,31,20,19,12,0,12,31,38.7,19,19,4,15,23,54,15,0,Matches
2581,Matt Targett,ENG,DF,Newcastle Utd,Premier League,26,1995,6.8,13,10,8,3,2,9,24,37.5,15,8,3,5,9,22,16,0,Matches
2582,James Tarkowski,ENG,DF,Everton,Premier League,29,1992,38.0,51,26,36,13,2,20,38,52.6,18,99,78,21,51,102,201,3,Matches
2583,Ciprian Tătărușanu,ROU,GK,Milan,Serie A,36,1986,16.0,0,0,0,0,0,0,0,0.0,0,0,0,0,1,1,2,0,Matches
2584,Niklas Tauer,GER,"DF,MF",Mainz 05,Bundesliga,21,2001,1.0,2,1,2,0,0,1,3,33.3,2,2,1,1,2,4,4,0,Matches
2585,Nuno Tavares,POR,"DF,MF",Marseille,Ligue 1,22,2000,26.1,56,30,19,24,13,28,55,50.9,27,32,4,28,15,71,25,0,Matches
2586,Marcus Tavernier,ENG,"MF,FW",Bournemouth,Premier League,23,1999,19.4,33,22,19,11,3,11,32,34.4,21,25,4,21,9,42,23,0,Matches
2587,Enzo Tchato,CMR,DF,Montpellier,Ligue 1,19,2002,12.2,26,17,14,11,1,13,22,59.1,9,17,2,15,7,33,33,0,Matches
2588,Aurélien Tchouaméni,FRA,MF,Real Madrid,La Liga,22,2000,23.5,64,40,23,36,5,23,38,60.5,15,20,6,14,49,113,50,0,Matches
2589,Mathys Tel,FRA,FW,Bayern Munich,Bundesliga,17,2005,4.6,2,2,0,1,1,1,1,100.0,0,5,1,4,0,2,2,0,Matches
2590,Semir Telalovic,GER,"MF,FW",M'Gladbach,Bundesliga,22,1999,0.1,0,0,0,0,0,0,0,0.0,0,0,0,0,0,0,0,0,Matches
2591,Alex Telles,BRA,DF,Sevilla,La Liga,29,1992,15.9,21,13,15,6,0,13,25,52.0,12,17,5,12,20,41,38,0,Matches
2592,Marc-André ter Stegen,GER,GK,Barcelona,La Liga,30,1992,37.2,0,0,0,0,0,0,0,0.0,0,0,0,0,1,1,7,3,Matches
2593,Simon Terodde,GER,FW,Schalke 04,Bundesliga,34,1988,20.3,15,8,4,7,4,3,14,21.4,11,6,2,4,6,21,9,0,Matches
2594,Filippo Terracciano,ITA,"DF,MF",Hellas Verona,Serie A,19,2003,9.1,20,13,11,7,2,15,20,75.0,5,7,4,3,10,30,14,0,Matches
2595,Pietro Terracciano,ITA,GK,Fiorentina,Serie A,32,1990,29.0,2,1,2,0,0,2,3,66.7,1,0,0,0,1,3,14,0,Matches
2596,Ramón Terrats,ESP,MF,Villarreal,La Liga,21,2000,9.1,15,10,3,8,4,9,17,52.9,8,11,4,7,8,23,6,2,Matches
2597,Ramón Terrats,ESP,MF,Girona,La Liga,21,2000,2.4,4,2,1,3,0,2,6,33.3,4,6,2,4,3,7,3,1,Matches
2598,Martin Terrier,FRA,"FW,MF",Rennes,Ligue 1,25,1997,14.7,25,11,7,9,9,13,24,54.2,11,15,2,13,14,39,6,0,Matches
2599,Aleksa Terzić,SRB,DF,Fiorentina,Serie A,22,1999,10.4,16,9,9,4,3,11,21,52.4,10,13,4,9,5,21,16,0,Matches
2600,Tetê,BRA,FW,Leicester City,Premier League,22,2000,8.2,14,8,5,7,2,6,21,28.6,15,9,0,9,2,16,3,0,Matches
2601,Tetê,BRA,"FW,MF",Lyon,Ligue 1,22,2000,12.3,21,10,8,5,8,10,19,52.6,9,9,0,9,13,34,2,0,Matches
2602,Kenny Tete,NED,DF,Fulham,Premier League,26,1995,28.5,83,46,41,29,13,38,50,76.0,12,48,17,31,52,135,81,1,Matches
2603,Florian Thauvin,FRA,"FW,MF",Udinese,Serie A,29,1993,6.1,2,1,0,2,0,2,13,15.4,11,5,0,5,2,4,2,0,Matches
2604,Arthur Theate,BEL,DF,Rennes,Ligue 1,22,2000,34.7,29,19,17,8,4,17,30,56.7,13,26,14,12,30,59,114,3,Matches
2605,Malick Thiaw,GER,DF,Milan,Serie A,20,2001,15.1,31,26,22,9,0,11,20,55.0,9,11,5,6,12,43,65,1,Matches
2606,Malick Thiaw,GER,DF,Schalke 04,Bundesliga,20,2001,3.0,3,1,2,1,0,1,2,50.0,1,4,3,1,9,12,24,1,Matches
2607,Jan Thielmann,GER,FW,Köln,Bundesliga,20,2002,9.7,9,8,3,4,2,2,11,18.2,9,16,3,13,9,18,7,0,Matches
2608,Sada Thioub,SEN,"DF,FW",Angers,Ligue 1,27,1995,11.8,19,10,9,8,2,8,17,47.1,9,13,0,13,7,26,5,1,Matches
2609,Luke Thomas,ENG,DF,Leicester City,Premier League,21,2001,11.9,23,19,15,5,3,15,32,46.9,17,20,4,16,27,50,35,0,Matches
2610,Adrien Thomasson,FRA,MF,Strasbourg,Ligue 1,28,1993,10.4,19,9,8,6,5,9,30,30.0,21,18,0,18,3,22,2,0,Matches
2611,Adrien Thomasson,FRA,"MF,FW",Lens,Ligue 1,28,1993,14.2,24,17,8,11,5,12,45,26.7,33,25,2,23,4,28,17,0,Matches
2612,Morten Thorsby,NOR,MF,Union Berlin,Bundesliga,26,1996,9.3,22,10,9,11,2,13,21,61.9,8,11,5,6,3,25,20,0,Matches
2613,Kristian Thorstvedt,NOR,MF,Sassuolo,Serie A,23,1999,12.6,16,7,4,9,3,6,17,35.3,11,19,5,14,14,30,13,0,Matches
2614,Khéphren Thuram,FRA,MF,Nice,Ligue 1,21,2001,28.3,51,25,22,23,6,19,43,44.2,24,33,13,20,38,89,34,0,Matches
2615,Marcus Thuram,FRA,FW,M'Gladbach,Bundesliga,24,1997,27.9,14,7,3,6,5,6,13,46.2,7,20,3,17,6,20,22,0,Matches
2616,Alexis Tibidi,FRA,"FW,MF",Troyes,Ligue 1,18,2003,0.8,1,1,1,0,0,0,0,0.0,0,0,0,0,0,1,0,0,Matches
2617,Youri Tielemans,BEL,MF,Leicester City,Premier League,25,1997,26.0,66,39,27,30,9,23,61,37.7,38,35,8,27,28,94,24,1,Matches
2618,Kieran Tierney,SCO,DF,Arsenal,Premier League,25,1997,8.8,20,11,9,9,2,12,16,75.0,4,8,2,6,11,31,25,0,Matches
2619,Steffen Tigges,GER,FW,Köln,Bundesliga,24,1998,17.7,12,7,1,8,3,4,14,28.6,10,13,2,11,8,20,17,0,Matches
2620,Jean-Clair Todibo,FRA,DF,Nice,Ligue 1,22,1999,31.9,76,48,54,19,3,41,56,73.2,15,41,19,22,41,117,110,2,Matches
2621,Harry Toffolo,ENG,DF,Nott'ham Forest,Premier League,26,1995,10.4,17,8,10,4,3,10,14,71.4,4,16,8,8,10,27,33,0,Matches
2622,Umut Tohumcu,GER,"MF,DF",Hoffenheim,Bundesliga,17,2004,3.0,10,5,4,5,1,3,9,33.3,6,4,0,4,2,12,8,0,Matches
2623,Karl Toko Ekambi,CMR,"FW,MF",Rennes,Ligue 1,29,1992,10.8,3,1,1,1,1,3,9,33.3,6,5,0,5,9,12,3,0,Matches
2624,Karl Toko Ekambi,CMR,"FW,MF",Lyon,Ligue 1,29,1992,15.0,9,9,2,4,3,4,15,26.7,11,12,2,10,9,18,6,0,Matches
2625,Corentin Tolisso,FRA,MF,Lyon,Ligue 1,27,1994,22.6,44,27,16,23,5,25,66,37.9,41,25,5,20,24,68,23,1,Matches
2626,Jeremy Toljan,GER,DF,Sassuolo,Serie A,27,1994,29.7,36,23,17,14,5,22,33,66.7,11,31,14,17,18,54,60,1,Matches
2627,Rafael Tolói,ITA,DF,Atalanta,Serie A,31,1990,30.9,69,44,37,32,0,35,64,54.7,29,42,18,24,57,126,88,1,Matches
2628,Raúl de Tomás,ESP,FW,Rayo Vallecano,La Liga,27,1994,8.9,3,2,0,1,2,2,6,33.3,4,4,0,4,0,3,6,0,Matches
2629,Tiago Tomás,POR,"FW,MF",Stuttgart,Bundesliga,20,2002,14.3,10,4,2,4,4,8,13,61.5,5,9,2,7,1,11,5,0,Matches
2630,Takehiro Tomiyasu,JPN,DF,Arsenal,Premier League,23,1998,7.4,27,18,12,10,5,13,18,72.2,5,7,0,7,14,41,15,1,Matches
2631,James Tomkins,ENG,DF,Crystal Palace,Premier League,33,1989,3.8,4,2,2,1,1,1,3,33.3,2,3,2,1,5,9,19,0,Matches
2632,Fikayo Tomori,ENG,DF,Milan,Serie A,24,1997,30.7,70,34,44,25,1,22,34,64.7,12,46,25,21,29,99,88,1,Matches
2633,Sandro Tonali,ITA,MF,Milan,Serie A,22,2000,30.1,64,41,35,24,5,27,44,61.4,17,34,9,25,25,89,26,1,Matches
2634,Lorenzo Tonelli,ITA,DF,Empoli,Serie A,32,1990,0.2,0,0,0,0,0,0,1,0.0,1,0,0,0,0,0,0,0,Matches
2635,Ivan Toney,ENG,FW,Brentford,Premier League,26,1996,32.8,23,13,4,9,10,7,23,30.4,16,24,9,15,14,37,36,0,Matches
2636,Pablo Torre,ESP,"FW,MF",Barcelona,La Liga,19,2003,1.6,2,1,0,1,1,2,4,50.0,2,1,0,1,2,4,1,0,Matches
2637,David Torres,ESP,DF,Valladolid,La Liga,19,2003,4.3,1,1,0,1,0,1,1,100.0,0,4,2,2,3,4,8,0,Matches
2638,Ferrán Torres,ESP,"FW,MF",Barcelona,La Liga,22,2000,15.5,13,7,4,5,4,5,20,25.0,15,11,2,9,3,16,5,0,Matches
2639,Óliver Torres,ESP,"MF,FW",Sevilla,La Liga,27,1994,23.7,39,23,12,13,14,18,59,30.5,41,26,5,21,10,49,10,0,Matches
2640,Pau Torres,ESP,DF,Villarreal,La Liga,25,1997,33.9,43,25,25,13,5,23,36,63.9,13,36,27,9,13,56,146,3,Matches
2641,Roberto Torres,ESP,"FW,MF",Osasuna,La Liga,33,1989,0.1,0,0,0,0,0,0,0,0.0,0,0,0,0,0,0,0,0,Matches
2642,Lucas Torró,ESP,MF,Osasuna,La Liga,28,1994,27.5,48,32,28,15,5,18,42,42.9,24,24,3,21,42,90,64,1,Matches
2643,Nabil Touaizi,MAR,MF,Espanyol,La Liga,21,2001,0.0,0,0,0,0,0,0,0,0.0,0,0,0,0,0,0,0,0,Matches
2644,Almamy Touré,MLI,DF,Eint Frankfurt,Bundesliga,26,1996,4.4,13,7,7,5,1,5,9,55.6,4,9,2,7,10,23,8,0,Matches
2645,Birama Touré,MLI,MF,Auxerre,Ligue 1,30,1992,37.8,80,47,35,35,10,34,93,36.6,59,54,9,45,67,147,49,0,Matches
2646,Mohamed Toure,AUS,"FW,MF",Reims,Ligue 1,18,2004,0.3,0,0,0,0,0,0,0,0.0,0,0,0,0,0,0,0,0,Matches
2647,Souleymane Touré,FRA,DF,Marseille,Ligue 1,19,2003,0.8,2,1,1,1,0,1,2,50.0,1,1,0,1,0,2,5,0,Matches
2648,Souleymane Touré,FRA,DF,Auxerre,Ligue 1,19,2003,17.6,29,13,19,9,1,16,20,80.0,4,32,12,20,26,55,56,1,Matches
2649,Lucas Tousart,FRA,MF,Hertha BSC,Bundesliga,25,1997,32.7,73,38,35,28,10,27,60,45.0,33,42,6,36,48,121,75,1,Matches
2650,Yoann Touzghar,TUN,FW,Ajaccio,Ligue 1,35,1986,5.0,3,2,0,2,1,0,1,0.0,1,0,0,0,0,3,1,0,Matches
2651,Adama Traoré,ESP,"FW,MF",Wolves,Premier League,26,1996,16.6,14,7,7,4,3,4,9,44.4,5,8,1,7,3,17,17,0,Matches
2652,Bertrand Traoré,BFA,"FW,MF",Aston Villa,Premier League,26,1995,2.6,1,1,1,0,0,1,4,25.0,3,5,0,5,2,3,0,0,Matches
2653,Boubacar Traoré,MLI,MF,Wolves,Premier League,20,2001,4.6,12,5,4,5,3,3,7,42.9,4,4,2,2,7,19,1,0,Matches
2654,Charles Traore,MLI,DF,Nantes,Ligue 1,30,1992,5.4,8,5,5,2,1,5,7,71.4,2,9,2,7,10,18,12,0,Matches
2655,Hamari Traoré,MLI,DF,Rennes,Ligue 1,30,1992,28.1,48,32,26,15,7,28,52,53.8,24,33,7,26,38,86,64,0,Matches
2656,Kevin Trapp,GER,GK,Eint Frankfurt,Bundesliga,32,1990,33.0,1,1,1,0,0,0,2,0.0,2,2,0,2,0,1,10,0,Matches
2657,Mark Travers,IRL,GK,Bournemouth,Premier League,23,1999,11.5,0,0,0,0,0,0,0,0.0,0,1,0,1,0,0,6,0,Matches
2658,Óscar Trejo,ARG,"MF,FW",Rayo Vallecano,La Liga,34,1988,23.8,48,32,12,23,13,9,44,20.5,35,31,3,28,8,56,8,1,Matches
2659,Manu Trigueros,ESP,MF,Villarreal,La Liga,30,1991,9.2,20,14,9,5,6,9,22,40.9,13,9,2,7,5,25,4,0,Matches
2660,Christopher Trimmel,AUT,DF,Union Berlin,Bundesliga,35,1987,20.1,31,16,16,12,3,20,31,64.5,11,14,1,13,25,56,48,0,Matches
2661,Théo Trinker,FRA,MF,Nice,Ligue 1,21,2001,0.0,0,0,0,0,0,0,0,0.0,0,0,0,0,0,0,0,0,Matches
2662,Kieran Trippier,ENG,DF,Newcastle Utd,Premier League,31,1990,37.1,71,49,36,27,8,46,90,51.1,44,45,15,30,43,114,84,2,Matches
2663,William Troost-Ekong,NGA,DF,Salernitana,Serie A,28,1993,4.9,11,3,7,4,0,6,7,85.7,1,7,4,3,6,17,10,0,Matches
2664,Leandro Trossard,BEL,FW,Arsenal,Premier League,27,1994,10.3,12,7,4,2,6,6,18,33.3,12,18,0,18,6,18,3,1,Matches
2665,Leandro Trossard,BEL,"FW,MF",Brighton,Premier League,27,1994,14.6,10,6,7,1,2,1,8,12.5,7,17,0,17,6,16,1,0,Matches
2666,Adrien Truffert,FRA,DF,Rennes,Ligue 1,20,2001,21.7,62,32,36,17,9,31,46,67.4,15,32,8,24,22,84,55,0,Matches
2667,Frank Tsadjout,ITA,FW,Cremonese,Serie A,23,1999,11.7,10,8,3,6,1,3,9,33.3,6,7,1,6,8,18,9,0,Matches
2668,Kostas Tsimikas,GRE,DF,Liverpool,Premier League,26,1996,8.6,14,9,10,2,2,10,16,62.5,6,8,1,7,12,26,15,0,Matches
2669,Theocharis Tsingaras,GRE,MF,Toulouse,Ligue 1,21,2000,0.1,0,0,0,0,0,0,0,0.0,0,0,0,0,0,0,0,0,Matches
2670,Viktor Tsyhankov,UKR,MF,Girona,La Liga,24,1997,16.5,8,8,5,1,2,1,14,7.1,13,13,2,11,7,15,12,0,Matches
2671,Alessandro Tuia,ITA,DF,Lecce,Serie A,32,1990,5.7,10,6,6,4,0,3,9,33.3,6,3,1,2,15,25,29,0,Matches
2672,Martin Turk,SVN,GK,Sampdoria,Serie A,18,2003,4.0,0,0,0,0,0,0,0,0.0,0,0,0,0,0,0,1,0,Matches
2673,Beñat Turrientes,ESP,"MF,FW",Real Sociedad,La Liga,20,2002,1.2,3,3,3,0,0,1,5,20.0,4,2,0,2,0,3,3,0,Matches
2674,Tuta,BRA,DF,Eint Frankfurt,Bundesliga,23,1999,30.2,53,35,27,19,7,33,57,57.9,24,47,14,33,49,102,134,2,Matches
2675,Destiny Udogie,ITA,DF,Udinese,Serie A,19,2002,30.0,71,45,42,24,5,34,59,57.6,25,34,6,28,36,107,25,0,Matches
2676,Ike Ugbo,CAN,"FW,MF",Troyes,Ligue 1,23,1998,9.9,5,2,2,2,1,3,11,27.3,8,8,2,6,2,7,4,0,Matches
2677,Lesley Ugochukwu,FRA,MF,Rennes,Ligue 1,18,2004,14.8,36,19,13,20,3,16,24,66.7,8,24,10,14,21,57,16,0,Matches
2678,Samir Ujkani,KVX,GK,Empoli,Serie A,34,1988,0.1,0,0,0,0,0,0,0,0.0,0,0,0,0,0,0,0,0,Matches
2679,Sven Ulreich,GER,GK,Bayern Munich,Bundesliga,33,1988,3.0,1,1,1,0,0,1,1,100.0,0,0,0,0,0,1,0,1,Matches
2680,Lauren Ulrich,GER,MF,Stuttgart,Bundesliga,17,2005,0.1,1,1,0,0,1,0,0,0.0,0,0,0,0,0,1,0,0,Matches
2681,Samuel Umtiti,FRA,DF,Lecce,Serie A,28,1993,23.5,52,34,25,25,2,18,26,69.2,8,26,14,12,26,78,79,0,Matches
2682,Enes Ünal,TUR,FW,Getafe,La Liga,25,1997,33.0,26,14,5,19,2,7,25,28.0,18,19,2,17,6,32,35,0,Matches
2683,Deniz Undav,GER,"FW,MF",Brighton,Premier League,26,1996,7.0,7,4,2,2,3,2,8,25.0,6,4,1,3,0,7,1,0,Matches
2684,Cengiz Ünder,TUR,"MF,DF",Marseille,Ligue 1,25,1997,27.7,37,19,15,13,9,13,34,38.2,21,18,2,16,18,55,13,0,Matches
2685,Dayot Upamecano,FRA,DF,Bayern Munich,Bundesliga,23,1998,26.1,65,37,43,22,0,28,45,62.2,17,26,6,20,27,92,71,4,Matches
2686,Filip Uremović,CRO,DF,Hertha BSC,Bundesliga,25,1997,19.2,38,23,29,8,1,14,22,63.6,8,18,13,5,36,74,88,2,Matches
2687,Oscar Ureña,ESP,MF,Girona,La Liga,19,2003,1.1,4,2,2,2,0,2,3,66.7,1,2,0,2,1,5,0,0,Matches
2688,Jere Uronen,FIN,DF,Brest,Ligue 1,28,1994,3.3,8,5,4,4,0,7,12,58.3,5,6,2,4,7,15,5,0,Matches
2689,Jere Uronen,FIN,DF,Schalke 04,Bundesliga,28,1994,7.5,14,10,6,6,2,6,10,60.0,4,5,2,3,8,22,13,0,Matches
2690,Mark Uth,GER,"MF,FW",Köln,Bundesliga,30,1991,0.5,0,0,0,0,0,0,0,0.0,0,0,0,0,0,0,0,0,Matches
2691,Josha Vagnoman,GER,DF,Stuttgart,Bundesliga,21,2000,16.4,26,15,12,11,3,15,27,55.6,12,20,2,18,8,34,29,1,Matches
2692,Diego Valencia,CHI,"MF,FW",Salernitana,Serie A,22,2000,2.6,8,5,4,2,2,2,9,22.2,7,10,1,9,1,9,2,0,Matches
2693,Óscar Valentín,ESP,MF,Rayo Vallecano,La Liga,27,1994,28.4,92,51,29,50,13,46,121,38.0,75,60,9,51,44,136,30,0,Matches
2694,Emanuele Valeri,ITA,DF,Cremonese,Serie A,23,1998,30.9,54,27,29,21,4,29,69,42.0,40,17,3,14,22,76,44,1,Matches
2695,Yan Valery,TUN,DF,Southampton,Premier League,23,1999,0.5,0,0,0,0,0,0,0,0.0,0,1,0,1,0,0,3,0,Matches
2696,Yan Valery,TUN,DF,Angers,Ligue 1,23,1999,27.7,54,39,28,20,6,20,37,54.1,17,35,15,20,34,88,82,0,Matches
2697,Martin Valjent,SVK,DF,Mallorca,La Liga,26,1995,29.5,35,27,22,12,1,19,28,67.9,9,39,21,18,29,64,137,0,Matches
2698,Jesús Vallejo,ESP,DF,Real Madrid,La Liga,25,1997,0.2,0,0,0,0,0,0,0,0.0,0,0,0,0,0,0,0,0,Matches
2699,Manu Vallejo,ESP,"FW,MF",Girona,La Liga,25,1997,2.3,4,1,1,2,1,1,6,16.7,5,2,0,2,1,5,3,0,Matches
2700,Mattia Valoti,ITA,"MF,FW",Monza,Serie A,28,1993,5.0,17,10,7,9,1,5,16,31.3,11,13,3,10,3,20,6,0,Matches
2701,Federico Valverde,URU,"MF,FW",Real Madrid,La Liga,24,1998,27.8,31,20,14,11,6,13,26,50.0,13,31,4,27,17,48,15,0,Matches
2702,Virgil van Dijk,NED,DF,Liverpool,Premier League,31,1991,31.5,27,14,13,11,3,8,19,42.1,11,24,16,8,31,58,138,2,Matches
2703,Vanderson,BRA,"DF,MF",Monaco,Ligue 1,21,2001,24.6,84,48,36,34,14,44,75,58.7,31,36,9,27,48,132,36,1,Matches
2704,Raphaël Varane,FRA,DF,Manchester Utd,Premier League,29,1993,21.2,24,9,18,6,0,7,17,41.2,10,24,17,7,11,35,91,0,Matches
2705,Jamie Vardy,ENG,FW,Leicester City,Premier League,35,1987,20.6,10,5,4,3,3,1,7,14.3,6,17,3,14,2,12,30,0,Matches
2706,Ruben Vargas,SUI,"MF,FW",Augsburg,Bundesliga,23,1998,12.6,15,7,6,7,2,5,11,45.5,6,8,2,6,6,21,16,1,Matches
2707,Johan Vásquez,MEX,DF,Cremonese,Serie A,23,1998,20.1,41,26,34,7,0,18,39,46.2,21,27,20,7,45,86,93,1,Matches
2708,Jesus Vazquez,ESP,"DF,MF",Valencia,La Liga,19,2003,3.4,13,8,9,1,3,6,11,54.5,5,4,0,4,1,14,8,0,Matches
2709,Kevin Vázquez,ESP,"DF,MF",Celta Vigo,La Liga,29,1993,4.9,13,8,5,7,1,8,12,66.7,4,4,1,3,2,15,8,0,Matches
2710,Lucas Vázquez,ESP,DF,Real Madrid,La Liga,31,1991,12.7,34,23,22,10,2,20,28,71.4,8,10,0,10,7,41,13,0,Matches
2711,Matías Vecino,URU,MF,Lazio,Serie A,30,1991,18.8,47,27,13,23,11,23,48,47.9,25,33,10,23,16,63,39,1,Matches
2712,Gabriel Veiga,ESP,MF,Celta Vigo,La Liga,20,2002,25.5,43,19,14,25,4,16,52,30.8,36,30,3,27,21,64,6,0,Matches
2713,Renato Veiga,POR,DF,Augsburg,Bundesliga,19,2003,7.1,9,6,4,3,2,7,9,77.8,2,20,6,14,7,16,29,1,Matches
2714,Miloš Veljković,SRB,DF,Werder Bremen,Bundesliga,26,1995,25.2,30,19,17,13,0,18,29,62.1,11,32,16,16,33,63,103,0,Matches
2715,Miguel Veloso,POR,MF,Hellas Verona,Serie A,36,1986,12.9,33,10,20,12,1,16,26,61.5,10,26,6,20,6,39,14,0,Matches
2716,Joël Veltman,NED,DF,Brighton,Premier League,30,1992,24.3,62,32,44,14,4,37,57,64.9,20,27,8,19,19,81,51,0,Matches
2717,Micky van de Ven,NED,DF,Wolfsburg,Bundesliga,21,2001,33.0,45,30,26,18,1,28,39,71.8,11,42,24,18,26,71,108,2,Matches
2718,Unai Vencedor Paris,ESP,MF,Athletic Club,La Liga,21,2000,2.1,3,1,0,3,0,1,6,16.7,5,5,0,5,1,4,1,0,Matches
2719,Lorenzo Venuti,ITA,DF,Fiorentina,Serie A,27,1995,10.3,18,7,6,11,1,11,18,61.1,7,7,2,5,5,23,17,2,Matches
2720,Daniele Verde,ITA,"FW,MF",Spezia,Serie A,26,1996,11.1,4,4,3,0,1,3,7,42.9,4,6,0,6,8,12,4,0,Matches
2721,Simone Verdi,ITA,"MF,FW",Hellas Verona,Serie A,30,1992,12.2,15,10,7,5,3,6,17,35.3,11,8,1,7,0,15,2,0,Matches
2722,Gonzalo Verdú,ESP,DF,Elche,La Liga,33,1988,7.8,10,5,8,2,0,4,8,50.0,4,8,6,2,10,20,33,0,Matches
2723,Jordan Veretout,FRA,MF,Marseille,Ligue 1,29,1993,31.8,56,35,17,32,7,25,53,47.2,28,22,7,15,36,92,40,2,Matches
2724,Marco Verratti,ITA,MF,Paris S-G,Ligue 1,29,1992,24.4,76,49,34,36,6,38,89,42.7,51,42,6,36,27,103,11,3,Matches
2725,Valerio Verre,ITA,MF,Sampdoria,Serie A,28,1994,7.5,14,7,6,5,3,8,17,47.1,9,9,1,8,9,23,3,0,Matches
2726,Mikel Vesga,ESP,MF,Athletic Club,La Liga,29,1993,28.6,57,35,21,31,5,25,68,36.8,43,39,8,31,36,93,39,3,Matches
2727,Guglielmo Vicario,ITA,GK,Empoli,Serie A,25,1996,30.9,1,1,1,0,0,1,2,50.0,1,0,0,0,0,1,15,2,Matches
2728,João Victor,BRA,DF,Nantes,Ligue 1,24,1998,9.4,19,11,9,7,3,12,22,54.5,10,11,1,10,15,34,30,0,Matches
2729,Aleix Vidal,ESP,"MF,FW",Espanyol,La Liga,32,1989,11.4,11,5,6,3,2,4,22,18.2,18,21,2,19,15,26,14,0,Matches
2730,Clément Vidal,FRA,"DF,MF",Ajaccio,Ligue 1,22,2000,21.1,25,15,14,11,0,18,38,47.4,20,27,16,11,27,52,73,1,Matches
2731,Nacho Vidal,ESP,DF,Osasuna,La Liga,27,1995,13.9,27,14,16,6,5,17,32,53.1,15,17,4,13,19,46,33,1,Matches
2732,Gabriel Vidovic,CRO,FW,Bayern Munich,Bundesliga,18,2003,0.2,0,0,0,0,0,0,0,0.0,0,0,0,0,0,0,0,0,Matches
2733,Fabio Vieira,POR,"MF,FW",Arsenal,Premier League,22,2000,5.7,6,4,3,0,3,3,5,60.0,2,5,0,5,4,10,2,0,Matches
2734,Ronaldo Vieira,ENG,MF,Torino,Serie A,24,1998,0.2,1,0,0,1,0,1,1,100.0,0,0,0,0,0,1,2,0,Matches
2735,Ronaldo Vieira,ENG,MF,Sampdoria,Serie A,24,1998,9.1,18,10,4,12,2,10,13,76.9,3,15,5,10,13,31,10,2,Matches
2736,Emanuel Vignato,ITA,"MF,FW",Bologna,Serie A,21,2000,2.7,4,4,2,2,0,2,4,50.0,2,2,0,2,3,7,0,0,Matches
2737,Emanuel Vignato,ITA,"MF,FW",Empoli,Serie A,21,2000,0.6,2,0,2,0,0,0,0,0.0,0,0,0,0,0,2,1,0,Matches
2738,Samuele Vignato,ITA,"MF,FW",Monza,Serie A,18,2004,0.7,0,0,0,0,0,0,0,0.0,0,1,0,1,0,0,0,0,Matches
2739,Tonny Vilhena,NED,MF,Salernitana,Serie A,27,1995,25.2,44,22,16,23,5,20,50,40.0,30,17,7,10,18,62,21,0,Matches
2740,Toni Villa,ESP,MF,Valladolid,La Liga,27,1995,1.0,6,3,2,3,1,4,9,44.4,5,0,0,0,0,6,0,0,Matches
2741,Toni Villa,ESP,"MF,FW",Girona,La Liga,27,1995,9.9,25,18,9,11,5,10,23,43.5,13,8,0,8,8,33,3,0,Matches
2742,Asier Villalibre,ESP,FW,Athletic Club,La Liga,24,1997,1.1,0,0,0,0,0,0,0,0.0,0,0,0,0,0,0,1,0,Matches
2743,Gonzalo Villar,ESP,MF,Sampdoria,Serie A,24,1998,7.7,13,7,4,8,1,7,15,46.7,8,11,3,8,4,17,9,1,Matches
2744,Gonzalo Villar,ESP,MF,Getafe,La Liga,24,1998,5.1,10,5,1,6,3,6,14,42.9,8,9,2,7,6,16,5,0,Matches
2745,Iván Villar,ESP,GK,Celta Vigo,La Liga,25,1997,19.0,0,0,0,0,0,0,1,0.0,1,0,0,0,0,0,7,0,Matches
2746,Matías Viña,URU,DF,Bournemouth,Premier League,24,1997,5.1,19,11,9,8,2,14,30,46.7,16,13,1,12,4,23,22,0,Matches
2747,Matías Viña,URU,DF,Roma,Serie A,24,1997,0.6,3,1,1,1,1,1,3,33.3,2,5,1,4,2,5,5,0,Matches
2748,Rúben Vinagre,POR,"DF,MF",Everton,Premier League,23,1999,0.3,2,2,1,1,0,1,2,50.0,1,0,0,0,0,2,1,0,Matches
2749,Carlos Vinícius,BRA,FW,Fulham,Premier League,27,1995,12.3,4,1,0,2,2,0,4,0.0,4,7,0,7,0,4,10,0,Matches
2750,Alan Virginius,FRA,FW,Lille,Ligue 1,19,2003,2.9,3,2,1,1,1,0,4,0.0,4,0,0,0,2,5,1,0,Matches
2751,Mattia Viti,ITA,DF,Nice,Ligue 1,20,2002,7.0,4,2,1,1,2,2,5,40.0,3,9,3,6,8,12,22,0,Matches
2752,Vitinha,POR,FW,Marseille,Ligue 1,22,2000,5.2,15,7,0,6,9,3,11,27.3,8,3,0,3,2,17,6,0,Matches
2753,Vitinha,POR,MF,Paris S-G,Ligue 1,22,2000,27.2,58,25,21,27,10,27,83,32.5,56,27,4,23,25,83,15,0,Matches
2754,Daniel Vivian,ESP,DF,Athletic Club,La Liga,23,1999,26.4,57,32,36,16,5,36,45,80.0,9,27,14,13,24,81,90,3,Matches
2755,Dušan Vlahović,SRB,FW,Juventus,Serie A,22,2000,21.4,11,6,0,7,4,4,10,40.0,6,10,3,7,3,14,8,1,Matches
2756,Nikola Vlašić,CRO,"MF,FW",Torino,Serie A,24,1997,30.3,32,21,9,16,7,15,34,44.1,19,25,2,23,10,42,14,0,Matches
2757,Joel Voelkerling Persson,SWE,"FW,MF",Lecce,Serie A,19,2003,1.1,1,1,0,0,1,0,1,0.0,1,1,0,1,0,1,0,0,Matches
2758,Kevin Vogt,GER,DF,Hoffenheim,Bundesliga,30,1991,19.7,15,10,10,5,0,9,22,40.9,13,18,11,7,26,41,67,0,Matches
2759,Mërgim Vojvoda,KVX,DF,Torino,Serie A,27,1995,19.1,22,12,15,6,1,12,24,50.0,12,14,2,12,10,32,31,1,Matches
2760,Kevin Volland,GER,"FW,MF",Monaco,Ligue 1,30,1992,7.1,8,4,1,5,2,2,8,25.0,6,8,0,8,2,10,0,0,Matches
2761,Cristian Volpato,ITA,MF,Roma,Serie A,18,2003,2.5,3,2,1,1,1,0,2,0.0,2,2,0,2,2,5,0,0,Matches
2762,Lukáš Vorlický,CZE,"MF,FW",Atalanta,Serie A,20,2002,0.3,0,0,0,0,0,0,0,0.0,0,0,0,0,1,1,0,0,Matches
2763,Aster Vranckx,BEL,MF,Milan,Serie A,19,2002,2.7,3,2,0,2,1,2,7,28.6,5,3,1,2,2,5,1,0,Matches
2764,Aster Vranckx,BEL,MF,Wolfsburg,Bundesliga,19,2002,0.1,0,0,0,0,0,0,0,0.0,0,0,0,0,0,0,1,0,Matches
2765,Stefan de Vrij,NED,DF,Inter,Serie A,30,1992,21.6,28,18,19,9,0,8,14,57.1,6,18,10,8,40,68,80,0,Matches
2766,Robert Wagner,GER,MF,Freiburg,Bundesliga,19,2003,0.4,0,0,0,0,0,0,0,0.0,0,2,0,2,0,0,2,0,Matches
2767,Elye Wahi,FRA,FW,Montpellier,Ligue 1,19,2003,27.9,9,3,2,3,4,5,14,35.7,9,14,2,12,3,12,5,0,Matches
2768,Walace,BRA,MF,Udinese,Serie A,27,1995,35.4,82,39,42,31,9,41,90,45.6,49,47,12,35,51,133,51,1,Matches
2769,Theo Walcott,ENG,"FW,MF",Southampton,Premier League,33,1989,12.5,13,6,8,4,1,8,27,29.6,19,8,1,7,9,22,7,0,Matches
2770,Luca Waldschmidt,GER,"FW,MF",Wolfsburg,Bundesliga,26,1996,5.8,5,2,2,1,2,2,10,20.0,8,6,0,6,3,8,5,0,Matches
2771,Kyle Walker,ENG,DF,Manchester City,Premier League,32,1990,21.8,13,9,8,5,0,4,24,16.7,20,12,2,10,18,31,22,0,Matches
2772,Kyle Walker-Peters,ENG,DF,Southampton,Premier League,25,1997,29.4,61,32,34,24,3,22,42,52.4,20,47,8,39,27,88,52,0,Matches
2773,Sebastian Walukiewicz,POL,DF,Empoli,Serie A,22,2000,6.7,9,6,7,2,0,4,6,66.7,2,10,9,1,7,16,30,0,Matches
2774,Aaron Wan-Bissaka,ENG,DF,Manchester Utd,Premier League,24,1997,15.9,40,25,20,17,3,23,25,92.0,2,24,8,16,22,62,41,0,Matches
2775,Paul Wanner,GER,MF,Bayern Munich,Bundesliga,16,2005,0.3,3,1,1,2,0,1,1,100.0,0,0,0,0,0,3,1,0,Matches
2776,Danny Ward,WAL,GK,Leicester City,Premier League,29,1993,26.0,1,1,1,0,0,1,3,33.3,2,0,0,0,0,1,14,2,Matches
2777,Joel Ward,ENG,DF,Crystal Palace,Premier League,32,1989,25.1,50,36,30,11,9,30,41,73.2,11,32,16,16,25,75,80,1,Matches
2778,James Ward-Prowse,ENG,MF,Southampton,Premier League,27,1994,37.5,65,37,31,27,7,21,61,34.4,40,30,10,20,55,120,48,0,Matches
2779,Ollie Watkins,ENG,FW,Aston Villa,Premier League,26,1995,34.7,19,13,3,13,3,10,27,37.0,17,21,4,17,10,29,39,0,Matches
2780,Timothy Weah,USA,"DF,FW",Lille,Ligue 1,22,2000,19.4,24,14,13,9,2,16,29,55.2,13,17,3,14,23,47,18,0,Matches
2781,Adam Webster,ENG,DF,Brighton,Premier League,27,1995,22.1,22,12,10,9,3,11,19,57.9,8,30,19,11,19,41,55,4,Matches
2782,Wout Weghorst,NED,"FW,MF",Manchester Utd,Premier League,29,1992,8.9,11,5,6,1,4,2,9,22.2,7,7,2,5,7,18,9,0,Matches
2783,Julian Weigl,GER,MF,M'Gladbach,Bundesliga,26,1995,21.0,43,16,21,21,1,23,41,56.1,18,23,2,21,18,61,32,0,Matches
2784,Nelson Weiper,GER,"FW,DF",Mainz 05,Bundesliga,17,2005,1.1,2,0,0,0,2,1,3,33.3,2,2,0,2,0,2,1,0,Matches
2785,Mitchell Weiser,GER,"DF,FW",Werder Bremen,Bundesliga,28,1994,28.0,71,43,38,24,9,38,75,50.7,37,50,7,43,28,99,38,1,Matches
2786,Noah Weißhaupt,GER,"MF,DF",Freiburg,Bundesliga,20,2001,4.7,11,6,3,7,1,2,7,28.6,5,4,0,4,6,17,8,0,Matches
2787,Shon Weissman,ISR,FW,Valladolid,La Liga,26,1996,8.3,2,1,1,1,0,0,4,0.0,4,8,0,8,1,3,7,0,Matches
2788,Danny Welbeck,ENG,FW,Brighton,Premier League,31,1990,20.6,15,7,0,7,8,4,11,36.4,7,24,2,22,5,20,20,0,Matches
2789,Marcel Wenig,GER,MF,Eint Frankfurt,Bundesliga,18,2004,0.0,0,0,0,0,0,0,0,0.0,0,0,0,0,0,0,0,0,Matches
2790,Axel Werner,ARG,GK,Elche,La Liga,26,1996,2.0,0,0,0,0,0,0,1,0.0,1,0,0,0,0,0,0,0,Matches
2791,Timo Werner,GER,"FW,MF",RB Leipzig,Bundesliga,26,1996,21.5,10,5,4,3,3,4,12,33.3,8,12,0,12,7,17,5,0,Matches
2792,Ben White,ENG,DF,Arsenal,Premier League,24,1997,33.9,60,31,23,30,7,42,70,60.0,28,47,11,36,22,82,79,1,Matches
2793,Harvey White,ENG,MF,Tottenham,Premier League,20,2001,0.1,0,0,0,0,0,0,1,0.0,1,0,0,0,0,0,0,0,Matches
2794,Joseph Whitworth,ENG,GK,Crystal Palace,Premier League,18,2004,2.0,0,0,0,0,0,0,0,0.0,0,0,0,0,0,0,1,0,Matches
2795,Silvan Widmer,SUI,DF,Mainz 05,Bundesliga,29,1993,18.8,26,17,15,10,1,20,39,51.3,19,22,8,14,31,57,28,0,Matches
2796,Mateusz Wieteska,POL,DF,Clermont Foot,Ligue 1,25,1997,34.6,41,23,28,13,0,19,33,57.6,14,44,28,16,56,97,97,4,Matches
2797,Georginio Wijnaldum,NED,MF,Roma,Serie A,31,1990,8.5,4,3,1,3,0,0,2,0.0,2,7,1,6,2,6,3,0,Matches
2798,Iñaki Williams,GHA,FW,Athletic Club,La Liga,28,1994,31.5,22,16,5,14,3,9,24,37.5,15,18,3,15,7,29,34,0,Matches
2799,Neco Williams,WAL,DF,Nott'ham Forest,Premier League,21,2001,20.9,72,47,49,17,6,38,71,53.5,33,33,8,25,33,105,48,0,Matches
2800,Nico Williams,ESP,FW,Athletic Club,La Liga,20,2002,29.5,31,16,10,15,6,19,41,46.3,22,40,2,38,8,39,14,1,Matches
2801,Willian,BRA,FW,Fulham,Premier League,33,1988,23.6,13,8,8,3,2,7,25,28.0,18,13,0,13,9,22,9,0,Matches
2802,Joe Willock,ENG,MF,Newcastle Utd,Premier League,22,1999,28.4,51,30,13,26,12,25,58,43.1,33,54,8,46,25,76,17,0,Matches
2803,Callum Wilson,ENG,FW,Newcastle Utd,Premier League,30,1992,20.9,9,3,0,8,1,0,3,0.0,3,8,0,8,1,10,5,0,Matches
2804,Harry Wilson,WAL,FW,Fulham,Premier League,25,1997,12.2,21,13,9,9,3,8,18,44.4,10,17,2,15,6,27,14,0,Matches
2805,Patrick Wimmer,AUT,"FW,MF",Wolfsburg,Bundesliga,21,2001,18.3,39,26,18,11,10,12,38,31.6,26,27,2,25,15,54,15,0,Matches
2806,Jonas Wind,DEN,FW,Wolfsburg,Bundesliga,23,1999,14.3,14,6,2,7,5,5,10,50.0,5,14,4,10,1,15,10,0,Matches
2807,Harry Winks,ENG,MF,Sampdoria,Serie A,26,1996,19.1,27,12,7,18,2,14,43,32.6,29,14,8,6,24,51,24,0,Matches
2808,Frederik Winther,DEN,DF,Augsburg,Bundesliga,21,2001,1.0,2,2,1,1,0,0,2,0.0,2,1,1,0,0,2,7,0,Matches
2809,Florian Wirtz,GER,"FW,MF",Leverkusen,Bundesliga,19,2003,12.1,18,10,9,7,2,8,16,50.0,8,15,1,14,1,19,6,0,Matches
2810,Przemysław Wiśniewski,POL,DF,Spezia,Serie A,24,1998,11.1,13,6,7,6,0,6,18,33.3,12,16,8,8,11,24,66,0,Matches
2811,Yoane Wissa,COD,FW,Brentford,Premier League,25,1996,17.8,17,12,4,7,6,6,13,46.2,7,10,0,10,6,23,15,0,Matches
2812,Axel Witsel,BEL,"DF,MF",Atlético Madrid,La Liga,33,1989,25.1,36,22,22,11,3,17,31,54.8,14,20,11,9,23,59,76,0,Matches
2813,Maximilian Wöber,AUT,DF,Leeds United,Premier League,24,1998,14.1,25,18,9,15,1,16,24,66.7,8,32,14,18,27,52,67,1,Matches
2814,Hannes Wolf,AUT,FW,M'Gladbach,Bundesliga,23,1999,5.0,11,8,4,5,2,5,13,38.5,8,3,0,3,3,14,9,0,Matches
2815,Marius Wolf,GER,DF,Dortmund,Bundesliga,27,1995,17.4,25,18,9,12,4,16,29,55.2,13,40,10,30,18,43,22,1,Matches
2816,Jeong Woo-yeong,KOR,"MF,FW",Freiburg,Bundesliga,22,1999,7.3,7,3,4,2,1,2,5,40.0,3,7,1,6,1,8,7,0,Matches
2817,Chris Wood,NZL,FW,Newcastle Utd,Premier League,30,1991,5.0,5,4,0,3,2,3,5,60.0,2,2,2,0,1,6,7,0,Matches
2818,Chris Wood,NZL,FW,Nott'ham Forest,Premier League,30,1991,4.1,0,0,0,0,0,0,1,0.0,1,2,1,1,1,1,2,0,Matches
2819,Christopher Wooh,CMR,DF,Rennes,Ligue 1,20,2001,11.2,16,7,8,8,0,9,11,81.8,2,11,5,6,6,22,49,0,Matches
2820,Christopher Wooh,CMR,MF,Lens,Ligue 1,20,2001,0.0,0,0,0,0,0,0,1,0.0,1,0,0,0,0,0,1,0,Matches
2821,Joe Worrall,ENG,DF,Nott'ham Forest,Premier League,25,1997,24.7,53,25,39,12,2,25,35,71.4,10,33,23,10,26,79,111,1,Matches
2822,Xeka,POR,MF,Rennes,Ligue 1,27,1994,6.1,10,3,6,3,1,7,16,43.8,9,11,2,9,6,16,8,0,Matches
2823,Granit Xhaka,SUI,MF,Arsenal,Premier League,29,1992,33.3,34,27,11,18,5,16,41,39.0,25,28,10,18,15,49,45,1,Matches
2824,Lamine Yamal,ESP,FW,Barcelona,La Liga,15,2007,0.1,0,0,0,0,0,0,0,0.0,0,0,0,0,0,0,0,0,Matches
2825,Jawad El Yamiq,MAR,DF,Valladolid,La Liga,30,1992,17.9,17,11,10,7,0,6,11,54.5,5,27,19,8,37,54,101,0,Matches
2826,Ryan Yates,ENG,MF,Nott'ham Forest,Premier League,24,1997,20.4,38,19,19,16,3,14,22,63.6,8,26,8,18,10,48,44,0,Matches
2827,Yusuf Yazıcı,TUR,MF,Lille,Ligue 1,25,1997,2.2,0,0,0,0,0,0,0,0.0,0,2,0,2,0,0,1,0,Matches
2828,Kelvin Yeboah,ITA,"FW,MF",Augsburg,Bundesliga,22,2000,3.9,6,4,2,4,0,2,5,40.0,3,7,0,7,1,7,2,0,Matches
2829,Gerard Yepes,ESP,MF,Sampdoria,Serie A,19,2002,2.2,5,3,2,3,0,1,3,33.3,2,3,0,3,4,9,3,0,Matches
2830,Darlin Yongwa,CMR,DF,Lorient,Ligue 1,21,2000,8.7,13,11,7,5,1,4,15,26.7,11,13,1,12,5,18,11,0,Matches
2831,Leny Yoro,FRA,DF,Lille,Ligue 1,16,2005,8.5,11,5,8,3,0,4,9,44.4,5,6,1,5,18,29,27,1,Matches
2832,Maya Yoshida,JPN,DF,Schalke 04,Bundesliga,33,1988,28.4,34,22,19,13,2,18,29,62.1,11,40,29,11,46,80,132,2,Matches
2833,Ashley Young,ENG,DF,Aston Villa,Premier League,37,1985,22.6,50,27,34,15,1,37,49,75.5,12,25,11,14,21,71,65,0,Matches
2834,Mohamed Youssouf,COM,DF,Ajaccio,Ligue 1,34,1988,27.3,72,44,41,24,7,38,61,62.3,23,32,8,24,65,137,70,0,Matches
2835,Illia Zabarnyi,UKR,DF,Bournemouth,Premier League,19,2002,3.3,4,2,4,0,0,3,7,42.9,4,7,2,5,3,7,14,0,Matches
2836,Mattia Zaccagni,ITA,FW,Lazio,Serie A,27,1995,30.8,42,28,16,18,8,14,38,36.8,24,37,3,34,21,63,10,1,Matches
2837,Dan-Axel Zagadou,FRA,DF,Stuttgart,Bundesliga,23,1999,14.1,14,9,10,4,0,5,14,35.7,9,19,16,3,21,35,81,1,Matches
2838,Wilfried Zaha,CIV,"FW,MF",Crystal Palace,Premier League,29,1992,25.4,32,20,12,12,8,8,21,38.1,13,21,1,20,16,48,9,0,Matches
2839,Warren Zaire-Emery,FRA,"MF,DF",Paris S-G,Ligue 1,16,2006,10.3,17,10,5,10,2,8,29,27.6,21,11,0,11,12,29,17,0,Matches
2840,Denis Zakaria,SUI,MF,Chelsea,Premier League,25,1996,4.6,9,5,5,2,2,2,8,25.0,6,4,1,3,3,12,10,0,Matches
2841,Denis Zakaria,SUI,MF,Juventus,Serie A,25,1996,1.4,6,3,1,4,1,2,2,100.0,0,2,0,2,2,8,1,0,Matches
2842,Rodrigo Zalazar,URU,"MF,FW",Schalke 04,Bundesliga,22,1999,14.7,16,8,5,9,2,9,24,37.5,15,16,1,15,7,23,13,0,Matches
2843,Joseba Zaldúa,ESP,DF,Cádiz,La Liga,30,1992,7.1,15,8,10,4,1,7,10,70.0,3,4,2,2,11,26,22,0,Matches
2844,Nicola Zalewski,POL,DF,Roma,Serie A,20,2002,24.4,45,26,25,15,5,22,71,31.0,49,27,1,26,31,76,23,0,Matches
2845,Andre-Frank Zambo Anguissa,CMR,MF,Napoli,Serie A,26,1995,33.9,53,32,16,29,8,16,64,25.0,48,50,4,46,49,102,25,0,Matches
2846,Oliver Zandén,SWE,"DF,MF",Toulouse,Ligue 1,20,2001,1.6,2,1,1,0,1,2,5,40.0,3,0,0,0,1,3,7,0,Matches
2847,Luca Zanimacchia,ITA,"MF,FW",Cremonese,Serie A,24,1998,8.3,21,13,11,6,4,8,21,38.1,13,9,0,9,9,30,5,0,Matches
2848,Nicolò Zaniolo,ITA,"MF,FW",Roma,Serie A,23,1999,9.9,7,5,2,4,1,2,7,28.6,5,11,0,11,2,9,0,0,Matches
2849,Alessandro Zanoli,ITA,DF,Sampdoria,Serie A,21,2000,17.1,22,14,14,6,2,8,17,47.1,9,19,15,4,12,34,39,0,Matches
2850,Alessandro Zanoli,ITA,DF,Napoli,Serie A,21,2000,0.1,1,0,0,1,0,0,0,0.0,0,0,0,0,0,1,1,0,Matches
2851,Mattia Zanotti,ITA,DF,Inter,Serie A,19,2003,0.3,0,0,0,0,0,0,1,0.0,1,2,0,2,0,0,0,0,Matches
2852,Duván Zapata,COL,FW,Atalanta,Serie A,31,1991,15.4,8,4,1,3,4,3,5,60.0,2,6,2,4,4,12,17,1,Matches
2853,Davide Zappacosta,ITA,DF,Atalanta,Serie A,30,1992,16.3,34,18,17,12,5,15,22,68.2,7,23,2,21,9,43,16,0,Matches
2854,Oier Zarraga,ESP,MF,Athletic Club,La Liga,23,1999,9.5,14,9,5,7,2,8,20,40.0,12,7,0,7,10,24,5,0,Matches
2855,Akim Zedadka,ALG,DF,Auxerre,Ligue 1,27,1995,17.8,35,21,21,10,4,18,32,56.3,14,17,3,14,23,58,51,1,Matches
2856,Akim Zedadka,ALG,"DF,MF",Lille,Ligue 1,27,1995,3.9,1,1,1,0,0,0,2,0.0,2,3,0,3,2,3,6,0,Matches
2857,Karim Zedadka,FRA,FW,Napoli,Serie A,22,2000,0.2,0,0,0,0,0,0,0,0.0,0,0,0,0,0,0,1,0,Matches
2858,Deyovaisio Zeefuik,NED,DF,Hellas Verona,Serie A,24,1998,0.1,1,1,0,1,0,0,0,0.0,0,0,0,0,0,1,0,0,Matches
2859,Marvin Zeegelaar,NED,DF,Udinese,Serie A,31,1990,3.9,8,4,6,2,0,3,4,75.0,1,2,0,2,3,11,5,0,Matches
2860,Mehdi Zeffane,ALG,"DF,MF",Clermont Foot,Ligue 1,30,1992,7.3,12,7,5,7,0,4,21,19.0,17,14,6,8,22,34,12,0,Matches
2861,Aaron Zehnter,GER,DF,Augsburg,Bundesliga,17,2004,0.0,0,0,0,0,0,0,1,0.0,1,0,0,0,1,1,0,0,Matches
2862,Jordan Zemura,ZIM,DF,Bournemouth,Premier League,22,1999,16.2,39,24,24,14,1,23,43,53.5,20,31,9,22,16,55,32,0,Matches
2863,Arber Zeneli,KVX,"FW,MF",Reims,Ligue 1,27,1995,11.1,9,3,3,3,3,5,12,41.7,7,8,0,8,2,11,2,0,Matches
2864,Robin Zentner,GER,GK,Mainz 05,Bundesliga,27,1994,26.0,0,0,0,0,0,0,4,0.0,4,0,0,0,0,0,17,1,Matches
2865,Alessio Zerbin,ITA,FW,Napoli,Serie A,23,1999,2.2,10,5,4,5,1,4,8,50.0,4,2,0,2,2,12,2,0,Matches
2866,Michael Zetterer,GER,GK,Werder Bremen,Bundesliga,27,1995,1.7,0,0,0,0,0,0,0,0.0,0,0,0,0,0,0,1,0,Matches
2867,Nathan Zeze,FRA,DF,Nantes,Ligue 1,17,2005,0.7,3,2,2,1,0,1,1,100.0,0,0,0,0,0,3,1,0,Matches
2868,Edon Zhegrova,KVX,"FW,MF",Lille,Ligue 1,23,1999,11.7,18,12,6,7,5,12,20,60.0,8,9,0,9,2,20,2,0,Matches
2869,Piotr Zieliński,POL,MF,Napoli,Serie A,28,1994,25.4,17,10,1,11,5,12,25,48.0,13,16,5,11,14,31,7,0,Matches
2870,David Zima,CZE,DF,Torino,Serie A,21,2000,4.5,9,5,5,4,0,3,4,75.0,1,7,2,5,9,18,11,2,Matches
2871,Oleksandr Zinchenko,UKR,DF,Arsenal,Premier League,25,1996,23.5,40,18,14,17,9,21,39,53.8,18,20,2,18,22,62,38,2,Matches
2872,Joshua Zirkzee,NED,FW,Bologna,Serie A,21,2001,9.1,4,2,1,1,2,2,7,28.6,5,4,1,3,4,8,4,0,Matches
2873,Hakim Ziyech,MAR,"FW,MF",Chelsea,Premier League,29,1993,7.3,20,12,12,5,3,4,9,44.4,5,8,0,8,5,25,5,1,Matches
2874,Jeroen Zoet,NED,GK,Spezia,Serie A,31,1991,3.7,1,1,1,0,0,1,1,100.0,0,0,0,0,0,1,1,0,Matches
2875,Simon Zoller,GER,FW,Bochum,Bundesliga,31,1991,16.2,11,4,2,8,1,4,12,33.3,8,14,1,13,6,17,21,0,Matches
2876,Nadir Zortea,ITA,"DF,MF",Atalanta,Serie A,23,1999,2.5,10,5,3,7,0,3,4,75.0,1,4,0,4,0,10,4,0,Matches
2877,Nadir Zortea,ITA,DF,Sassuolo,Serie A,23,1999,7.3,15,8,12,2,1,9,14,64.3,5,10,4,6,4,19,21,0,Matches
2878,Tanguy Zoukrou,FRA,DF,Troyes,Ligue 1,19,2003,5.7,14,7,8,6,0,10,14,71.4,4,18,11,7,2,16,24,0,Matches
2879,Kurt Zouma,FRA,DF,West Ham,Premier League,27,1994,22.1,9,4,4,5,0,5,8,62.5,3,17,14,3,30,39,120,1,Matches
2880,Petar Zovko,BIH,GK,Spezia,Serie A,20,2002,0.8,1,0,1,0,0,1,1,100.0,0,0,0,0,0,1,0,0,Matches
2881,Igor Zubeldia,ESP,DF,Real Sociedad,La Liga,25,1997,28.2,35,18,28,7,0,25,35,71.4,10,23,17,6,21,56,93,0,Matches
2882,Martín Zubimendi,ESP,MF,Real Sociedad,La Liga,23,1999,34.5,59,33,23,30,6,24,45,53.3,21,44,17,27,37,96,55,4,Matches
2883,Szymon Żurkowski,POL,MF,Fiorentina,Serie A,24,1997,0.4,0,0,0,0,0,0,0,0.0,0,0,0,0,0,0,0,0,Matches
2884,Szymon Żurkowski,POL,MF,Spezia,Serie A,24,1997,4.7,9,3,4,4,1,2,15,13.3,13,9,2,7,4,13,6,0,Matches
2885,Martin Ødegaard,NOR,MF,Arsenal,Premier League,23,1998,34.7,36,23,12,14,10,14,47,29.8,33,20,5,15,6,42,12,1,Matches
2886,Milan Đurić,BIH,FW,Hellas Verona,Serie A,32,1990,15.2,2,1,1,0,1,1,3,33.3,2,7,4,3,1,3,24,0,Matches
2887,Filip Đuričić,SRB,"MF,FW",Sampdoria,Serie A,30,1992,24.1,43,22,18,20,5,14,32,43.8,18,19,6,13,7,50,8,0,Matches
2888,Blanco,0,MF,Cádiz,La Liga,22,2000,1.8,0,4,0,0,0,0,0,0.0,0,0,0,0,1,0,0,0,Matches
2889,Hugo Guillamón,0,"DF,MF",Valencia,La Liga,22,2000,18.1,0,14,0,0,0,0,0,0.0,0,0,0,0,19,0,0,0,Matches
